Gll, Gll, Gll, Gll, Gll, Gll, Gll, Gll, Gll, Gll, Gll, Gll, Gll, Gll, Gll, Gll, Gll^Fp, Gll^Fp, Gll^Fp, Gll^Fp, Gll^Fp, Gll^Fp, Gll^Fp, Gll^Fp, Gll^Fp, Gll^Fp, Gll^Fp, Gll, Gll, Gll, Gll, Gll, Gll, Gll, Gll, Gll, Gll, Gll, Wog, Wog, Ai, Ai, Aa, Aa, Aa, Aa
Gll, Gll, Gll, Gll, Gll, Gll, Gll, Gll, Gll, Gll, Gll, Gll, Gll, Gll, Gll, Gll, Gll^Fp, Gll^Fp, Gll^Fp, Gll^Fp, Re^Vct, Gll^Fp, Ce, Gll^Fp, Re^Vct, Gll^Fp, Gll^Fp, Gll^Fp, Gll, Gll, Gll, Gll, Gll, Gll, Gll, Gll, Wog, Wog, Wog, Wog, Ai, Ai, Aa, Aa, Aa, Aa
Gll, Gll, Gll, Gll, Gll, Gll, Gll, Gll, Gll, Gll, Gll, Gll, Gll, Gll, Gll^Fp, Gll, Gll^Fp, Gll^Fp, Gll^Fp, Gll^Fp, Gll^Fp, Ce, 1 Ke, Ce, Gll^Fp, Gll^Fp, Gll^Fp, Gll^Fp, Gll, Gll, Gll, Gll, Gll, Gll, Gll, Wog, Wog, Wog, Wog, Ai, Aa, Aa, Aa, Aa, Aa, Aa
Gll, Gll, Gll, Gll, Gll, Gll, Gll, Gll, Gll, Gll, Gll, Gll, Gll^Fp, Gll^Fp, Gll^Fp, Gll^Fp, Gll^Fp, Gll^Fp, Gll^Fp, Gll^Fp, Re^Vct, Ce, Ce, Ce, Re^Vct, Gll^Fp, Gll^Fp, Gll, Gll, Gll, Gll, Gll, Gll, Gll, Wog, Wog, Wog, Wog, Wog, Aa, Aa, Aa, Aa, Aa, Aa, Aa
Gll, Gll, Gll, Gll, Gll, Gll, Gll, Gll, Gll, Gll, Gll, Gll^Fp, Gll^Fp, Gll^Fp, Gll^Fp, Gll^Fp, Gll^Fp, Gll^Fp, Gll^Fp, Gll^Fp, Rrc, Rrc, Gll^Fp, Gll^Fp, Gll^Fp, Gll^Fp, Gll, Gll, Gll, Gll, Gll, Gll, Wog, Wog, Wog, Wog, Wog, Wog, Aa, Aa, Aa, Aa, Aa, Aa, Aa, Aa
Gll, Gll, Hh, Gll, Hh, Gs^Vh, Gll, Gll, Gll, Gll, Gll^Fp, Gll^Fp, Gll^Fp, Gll^Fp, Gll^Fp, Gll^Fp, Gll^Fp, Gll^Fp, Gll^Fp, Rrc, Gll^Fp, Gll^Fp, Gll^Fp, Gll^Fp, Gll^Fp, Gll^Fp, Gll, Gll, Gll, Gll, Wog, Wog, Wog, Wog, Ai, Ai, Aa^Voa, Aa^Voa, Aa^Voa, Aa, Aa, Aa, Aa, Aa, Aa, Aa
Hh, Hh, Hh, Hh, Hh^Vhh, Hh, Hh, Gll, Gll, Gll, Gll, Gll^Fp, Gll^Fp, Gll^Fp, Gll^Fp, Gll^Fp, Gll^Fp, Gll^Fp, Rrc, Rrc, Gll^Fp, Gll^Fp, Gll^Fp, Gll^Fp, Gll^Fp, Gll^Fp, Gll, Gll, Wog, Wog, Wog, Wog, Wog, Ai, Ai, Aa, Aa^Voa, Aa^Ecf, Aa^Voa, Aa, Aa^Voa, Aa, Aa, Aa, Aa, Aa
Hh, Hh^Vhh, Ch, Ch, Ch, Hh, Hh, Gs^Vh, Gll, Gll, Gll, Gll^Fp, Gll^Fp, Gll^Fp, Gll^Fp, Gll^Fp, Gll^Fp, Gll^Fp, Rrc, Gll^Fp, Gll^Fp, Gll^Fp, Gll^Fp, Gll^Fp, Gll^Fp, Gll^Fp, Gll, Gll, Wog, Wog, Wog, Wog, Wog, Ai, Aa^Voa, Aa, Co, Co, Co, Aa^Voa, Aa^Ecf, Aa^Voa, Aa, Aa, Aa, Aa
Hh, Hh, Ch, 2 Kh, Ch, Hh, Hh^Vhh, Gll, Gll, Gll, Gll, Gll, Gll, Gll^Fp, Gll^Fp, Gll^Fp, Gll^Fp, Gll^Fp, Rrc, Gll^Fp, Gll^Fp, Gll^Fp, Gll^Fp, Gll^Fp, Gll, Gll, Wog, Wog, Wog, Wog, Wog, Wog, Aa, Aa^Voa, Aa^Ecf, Aa^Voa, Co, 5 Ko, Co, Aa^Voa, Aa, Aa^Voa, Aa, Aa, Aa, Aa
Hh, Hh^Vhh, Hh, Ch, Rrc, Hh, Rrc, Gll, Gll, Gll, Gll, Gll, Gll, Gll^Fp, Gll^Fp, Gll^Fp, Gll^Fp, Gs^Fds, Rrc, Gll^Fp, Gll^Fp, Gll^Fp, Gll^Fp, Gll, Wog, Wog, Wog, Wog, Ai, Wog, Aa, Aa, Aa, Aa, Aa^Voa, Aa^Voa, Co, Co, Co, Aa, Aa, Aa, Aa, Aa, Aa, Aa
Gll, Hh, Hh, Hh, Hh, Rrc, Gll, Rrc, Rrc, Rrc, Rrc, Gll, Rrc, Gll, Gs^Fds, Gll^Fp, Gll^Fp, Gs^Fds, Rrc, Gll^Fp, Gll^Fp, Gll^Fp, Gll, Gll, Wog, Wog, Ai, Ai, Aa, Aa, Aa, Aa, Aa, Aa, Aa, Aa, Aa, Rrc, Aa, Aa, Aa, Aa, Aa, Aa, Aa, Aa
Gll, Gs^Vh, Gll, Hh^Vhh, Gll, Gll, Gll, Gll, Gll, Gll, Gll, Rrc, Gll, Rrc, Rrc, Gs^Fds, Gs^Fds, Gs^Fds, Rrc, Gll^Fp, Gll^Fp, Gll^Fp, Gll, Gll, Wog, Wog, Ai, Ai, Aa, Aa, Aa, Aa, Aa, Aa, Aa, Aa, Aa, Rrc, Aa, Aa, Aa, Aa, Aa, Aa, Xue, Aa
Gll, Gll, Gll, Gll, Gs^Vh, Gll, Gll, Gll, Gll, Gll^Fp, Gll^Fp, Gll, Gll, Gll, Gll, Rrc, Rrc, Gs^Fds, Rrc, Gll^Fp, Gll, Gll, Gll, Wog, Wog, Wog, Ai, Aa, Aa, Aa, Aa, Aa, Aa, Aa, Aa, Aa, Aa, Rrc, Aa, Aa, Aa, Aa, Xue, Xue, 4 Kud, Xue
Gll, Gll, Gll, Gll, Gll, Gll, Gll, Gll, Gll, Gll^Fp, Gll^Fp, Gll^Fp, Gll^Fp, Gll, Gll, Gll, Gll, Rrc, Gll, Rrc, Rrc, Gll, Gll, Wog, Wog, Wog, Wog, Aa, Aa, Aa, Aa, Aa, Aa, Aa, Aa, Aa, Rrc, Rrc, Rrc, Rrc, Rrc, Aa, Rrc, Cud, Cud, Xue
Gll, Gll, Gll, Gg, Gll, Gll, Gg, Gll, Gll, Gll^Fp, Gll^Fp, Gll^Fp, Gll^Fp, Gll^Fp, Gll^Fp, Gll, Gll, Gll, Gll, Gll, Gll, Rrc, Rrc, Wog, Wog, Wog, Aa, Aa, Aa^Vla, Aa, Aa, Aa, Aa, Aa, Rrc, Rrc, Aa, Aa, Aa, Aa, Aa, Rrc, Xue, Cud, Rr^Vd, Xue
Gll, Gll, Gll, Gll, Gll, Gll, Gll, Gll, Gll^Fp, Gll^Fp, Gll^Fp, Gll^Fp, Gll^Fp, Gll^Fp, Gll^Fp, Gll^Fp, Gll^Fp, Gll^Fp, Gll, Gll, Gll, Gll, Wog, Wog^Bw\, Wog^Bw\, Wog, Aa, Aa, Aa, Aa, Aa, Aa, Aa, Rrc, Aa, Aa, Aa, Aa, Aa, Aa, Aa, Aa, Aa, Xue, Rr^Vd, Xue
Gll, Gll, Gll, Gll, Gg, Gll, Gll, Gll, Gll^Fp, Gll^Fp, Gll^Fp, Gll^Fp, Gll^Fp, Gll^Fp, Gll^Fp, Gll^Fp, Gll^Fp, Gll^Fp, Gll, Gll, Gll, Gll, Wog, Wog, Wog, Wog^Bw\, Rrc, Aa, Aa, Aa, Aa, Aa, Rrc, Rrc, Aa, Aa, Aa, Aa, Aa, Aa, Aa, Aa, Aa, Xue, Xue, Xue
Gll, Gll, Gll, Gll, Gll, Gll, Gll, Gll^Fp, Gll^Fp, Gll^Fp, Gll, Gll, Gll, Gll, Gll, Gll, Gll, Gll, Gll, Gll, Wog, Wog, Wog, Wog, Ai, Aa, Aa, Rrc, Rrc, Aa, Rrc, Rrc, Aa, Aa, Aa, Aa, Aa, Aa, Aa, Aa, Aa, Aa, Aa, Aa, Aa, Aa
Gll, Gll, Gg, Gll, Gll, Gll^Fp, Gll^Fp, Gll^Fp, Gll^Fp, Gll, Gll, Gll, Gll, Gll, Gll, Gll, Wog, Gll, Wog, Wog, Wog, Wog, Ai, Ai, Aa, Aa, Aa, Aa, Aa, Rrc, Rrc, Aa, Aa, Aa, Aa, Aa, Aa, Aa, Aa, Aa, Aa, Aa, Aa, Aa, Aa, Aa
Gll, Gll, Gll, Gll, Gll^Fp, Gll^Fp, Gll^Fp, Gll^Fp, Gll, Gll, Gll, Gll, Wog, Wog, Wog, Wog, Wog, Wog, Wog, Wog, Ai, Ai, Aa, Aa, Aa, Aa, Aa, Aa, Aa, Aa, Rrc, Rrc, Rrc, Aa, Aa, Aa, Aa, Aa, Aa^Vla, Aa, Aa, Aa, Aa, Aa, Aa, Aa
Gll, Gll, Gg, Gll^Fp, Gll^Fp, Gll^Fp, Gll, Gll, Gll, Gll, Wog, Wog, Wog, Wog, Wog, Wog, Ai, Wog, Ai, Ai, Aa, Aa, Aa, Aa, Aa, Aa, Aa, Aa, Aa, Rrc, Aa, Aa, Aa, Rrc, Rrc, Aa, Aa, Aa, Aa, Aa, Aa, Aa, Aa, Aa, Aa, Aa
Gll, Gll, Gll, Gll, Gll, Gll, Gg, Gll, Gll, Wog, Wog, Wog, Wog, Wog, Wog, Ai, Aa, Ai, Aa, Aa, Aa, Aa, Aa, Aa, Aa, Aa, Aa, Aa, Rrc, Rrc, Aa, Aa, Aa, Aa, Aa, Rrc, Rrc, Aa, Aa, Aa, Aa, Aa, Aa, Aa, Aa, Aa
Gll, Gll, Gll, Gll, Gll, Gll, Gll, Gll, Wog, Wog, Wog, Ai, Wog, Aa, Aa, Aa, Aa, Aa, Aa, Aa, Aa, Aa, Aa, Aa, Aa, Aa, Aa, Rrc, Aa, Aa, Aa, Aa, Aa, Aa, Aa, Aa, Aa, Rrc, Rrc, Aa, Aa, Aa, Aa, Aa, Aa, Aa
Gll, Gll, Gll, Gll, Gll, Gll, Gll, Wog, Wog, Wog, Wog, Wog, Aa, Aa, Aa, Aa, Aa, Aa, Aa, Aa, Aa, Aa, Aa, Aa, Aa, Aa, Rrc, Rrc, Aa, Aa, Aa, Aa, Aa^Fpa, Aa, Aa, Aa, Aa, Aa, Aa, Rrc, Aa, Aa, Aa, Aa, Aa, Aa
Gll, Gll, Gll, Gll, Gll, Gll, Wog, Wog, Wog, Wog, Aa, Aa, Aa, Aa, Aa, Aa, Aa, Aa, Aa^Fpa, Aa, Aa^Fpa, Aa, Aa, Aa, Aa, Aa, Rrc, Aa, Aa^Fpa, Aa^Fpa, Aa^Fpa, Aa^Fpa, Aa^Fma, Aa^Fpa, Aa^Fpa, Aa, Aa, Aa, Aa, Rrc, Rrc, Aa, Aa, Aa, Aa, Aa
Gll, Gll, Gll, Gll, Gll, Wog, Wog, Wog, Wog, Ai, Aa, Aa, Aa^Fpa, Aa^Fpa, Aa^Fpa, Aa, Aa^Fpa, Aa^Fpa, Aa^Fpa, Aa^Fpa, Aa^Fpa, Aa^Fpa, Aa^Fma, Aa^Fma, Aa^Fma, Rrc, Aa^Fma, Aa^Fma, Aa^Fpa, Aa^Fpa, Aa^Fpa, Aa^Fpa, Aa^Fpa, Aa^Fma, Aa^Fpa, Aa, Aa, Aa, Aa, Aa, Rrc, Aa, Aa, Aa, Ha, Ha
Gll, Gll, Gll, Gll, Wog, Wog, Wog, Wog, Aa, Aa, Aa^Fpa, Aa^Fpa, Aa^Fpa, Aa^Fpa, Aa^Fpa, Aa^Fpa, Aa^Fpa, Aa^Fpa, Aa^Fpa, Aa^Fpa, Aa^Fpa, Aa^Fpa, Aa^Fma, Aa^Fma, Aa^Fma, Rrc, Aa^Fpa, Aa^Fpa, Aa^Fpa, Aa^Fpa, Aa^Fpa, Aa^Fpa, Aa^Fpa, Aa^Fma, Aa^Fpa, Aa, Aa, Aa, Aa, Aa, Aa, Rrc, Ha, Ha, Ms, Ms
Gll, Gll, Gll, Gll, Wog, Wog, Wog, Ai, Aa, Aa, Aa^Fpa, Aa^Fpa, Aa^Fda, Aa^Fda, Aa^Fda, Aa^Fda, Aa^Fda, Aa^Fpa, Aa^Fda, Aa^Fpa, Aa^Fpa, Aa^Fpa, Aa^Fpa, Aa^Fma, Aa^Fpa, Rrc, Aa^Fpa, Aa^Fpa, Aa^Fpa, Aa^Fma, Aa^Fda, Aa^Fpa, Aa^Fda, Aa^Fpa, Aa^Fpa, Aa, Aa, Aa, Aa, Aa, Ha, Rrc, Ms, Ms, Ms, Gg
Gll, Gll, Gll, Gll, Wog, Wog, Wog, Aa, Aa^Fpa, Aa^Fpa, Aa^Fda, Aa^Fda, Aa^Fpa, Aa^Fpa, Aa^Fpa, Aa^Fda, Aa^Fda, Aa^Fda, Aa^Fda, Aa^Fda, Aa^Fpa, Aa^Fpa, Aa^Fpa, Aa^Vea, Aa^Fpa, Rrc, Aa^Fma, Aa^Fpa, Aa^Vea, Aa^Fma, Aa^Fda, Aa^Fda, Aa^Fda, Aa^Fpa, Aa, Aa, Aa, Aa, Ha, Ha, Ms, Rrc, Ms, Ms^Xm, Ms^Xm, Ms^Xm
Gll, Gll, Gll, Wog, Wog, Wog, Wog, Aa, Aa^Fpa, Aa^Fpa, Aa^Fda, Aa^Fda, Aa^Fpa, Aa^Fpa, Aa^Fpa, Aa^Fda, Aa^Fda, Aa^Fda, Aa^Fda, Aa^Fpa, Aa^Fma, Aa^Vea, Aa^Fpa, Aa^Fpa, Cv, Cv, Cv, Aa^Fma, Aa^Fma, Aa^Fma, Aa^Fma, Aa^Fda, Aa^Fpa, Aa^Fpa, Aa, Aa, Ha, Ha, Ms, Ms, Xu, Rr^Pr|o, Xu, Ms^Xm, Ms^Xm, Ms^Xm
Wog, Wog, Wog, Wog, Wog, Wog, Ai, Aa, Aa^Fpa, Aa^Fpa, Aa^Fpa, Aa^Fda, Aa^Fma, Aa^Fpa, Aa^Fma, Aa^Fda, Aa^Fpa, Aa^Fpa, Aa^Fma, Aa^Fma, Aa^Fma, Aa^Fma, Aa^Vea, Cv, Cv, 6 Kv, Cv, Cv, Aa^Fma, Aa^Vea, Aa^Fma, Aa^Fma, Aa^Fda, Aa, Aa, Ha, Ms, Ms, Xu, Xu, Cud, Cud, Cud, Xu, Xu, Xu
Wog, Wog, Wog, Wog, Wog, Wog, Aa, Aa, Aa^Fpa, Aa^Fpa, Aa^Fpa, Aa^Fpa, Aa^Fma, Aa^Fma, Aa^Fma, Aa^Fma, Aa^Fma, Aa^Fma, Aa^Fma, Aa^Fma, Aa^Vea, Aa^Fma, Aa^Fda, Aa^Fpa, Aa^Fpa, Cv, Aa^Fpa, Aa^Vea, Aa^Fma, Aa^Fma, Aa^Fma, Aa^Fda, Aa^Fda, Aa^Fda, Aa, Ha, Ms, Ms^Xm, Xu, Uu^Vud, Cud, 3 Kud, Cud, Cud, Uu^Vud, Uu^Vud
Wog, Wog, Ai, Wog, Aa, Aa, Aa, Aa, Aa, Aa^Fpa, Aa^Fpa, Aa^Fpa, Aa^Fpa, Aa^Fma, Aa^Fma, Aa^Fma, Aa^Fma, Aa^Fma, Aa^Fma, Aa^Fma, Aa^Fpa, Aa^Fda, Aa^Fda, Aa^Vea, Aa^Fpa, Aa^Fpa, Aa^Fpa, Aa^Fpa, Aa^Fda, Aa^Fma, Aa^Fda, Aa^Fda, Aa^Fda, Aa^Fda, Aa, Ha, Ms, Ms^Xm, Xu, Uu^Vud, Cud, Cud, Uu^Vud, Uu^Vud, Uu^Vud, Uu^Vud
Ai, Ai, Aa, Aa, Aa, Aa, Aa, Aa, Aa, Aa, Aa, Aa^Fpa, Aa^Fpa, Aa^Fpa, Aa^Fpa, Aa^Fma, Aa^Fma, Aa^Fma, Aa^Fpa, Aa^Fma, Aa^Fpa, Aa^Fda, Aa^Fda, Aa^Fda, Aa^Fpa, Aa^Fpa, Aa^Fpa, Aa^Fpa, Aa^Fda, Aa^Fda, Aa^Fda, Aa^Fda, Aa^Fda, Aa^Fda, Aa, Ha, Ms, Ms^Xm, Xu, Uu^Vud, Uu^Vud, Uu^Vud, Uu^Vud, Uu^Vud, Uu^Vud, Uu^Vud
Aa, Aa, Aa, Aa, Aa, Aa, Aa, Aa, Aa, Aa, Aa, Aa, Aa, Aa^Fpa, Gg, Aa^Fpa, Aa^Fpa, Aa^Fpa, Aa, Aa^Fpa, Gg, Aa^Fpa, Aa^Fpa, Aa^Fpa, Aa^Fpa, Aa^Fpa, Aa^Fpa, Aa^Fpa, Aa^Fda, Aa^Fda, Aa^Fda, Aa^Fda, Aa, Aa, Aa, Ha, Ms, Ms^Xm, Xu, Uu^Vud, Uu^Vud, Uu^Vud, Uu^Vud, Uu^Vud, Uu^Vud, Uu^Vud
