Wog, Wog, Wog, Wog, Wog, Wog, Wog, Wog, Wog, Wog, Wog, Wog, Wog, Wog, Wog, Gg, Gg, Dd, Dd, Dd, Dd, Wwg, Gs, Wo, Wwg, Gs, Gs, Gs, Xom, Xom, Xom, Gs, Md, Mdd, Md, Md, Md, Dd, Gs, Dd, Gs, Ds, Ds, Wog, Wog, Wog, Wog, Wog, Wog, Wog, Wog, Wog, Wog, Wog, Wog, Wog, Wog, Wog, Wog, Wog, Wog, Wog, Ds, Dd, Dd, Dd, Dd, Dd, Dd, Dd, Dd, Dd, Dd, Dd, Dd, Dd, Dd, Dd, Dd, Dd
Wog, Wog, Wog, Wog, Wog, Wog, Wog, Wog, Wog, Wog, Wog, Wog, Wog, Wog, Wog, Gg, Gs^Fds, Gg, Dd, Dd, Dd, Wwg, Co, Co, Co, Wwg, Wwg, Gs, Xom, Rr^Vhc, Xom, Gs, Md, Md, Md, Md, Md, Gs, Gs^Vh, Gs^Vh, Gs, Ds, Wog, Wog, Wog, Wog, Wog, Wog, Wog, Wog, Wog, Wog, Wog, Wog, Wog, Wog, Wog, Wog, Wog, Wog, Wog, Wog, Ds, Dd, Dd, Dd, Dd, Dd, Dd, Dd, Dd, Dd, Dd, Dd, Dd, Dd, Dd, Dd, Dd, Dd
Wog, Wog, Wog, Wog, Wog, Wog, Wog, Wog, Wog, Wog, Wog, Wog, Wog, Wog, Wog, Gg, Gs^Fds, Gs^Fds, Gs, Dd, Gs^Vh, Wwg, Co, 5 Ko, Co, Co, Co, Wwg, Gs, Rr^Pr|, Gs, Gs, Md, Md, Md, Md, Md, Gs, Gs^Vh, Gs^Vh, Gs^Vh, Ds, Wog, Wog, Wog, Wog, Wog, Wog, Wog, Wog, Wog, Wog, Wog, Wog, Wog, Wog, Wog, Wog, Wog, Wog, Wog, Wog, Ds, Dd, Dd, Dd, Dd, Dd, Dd, Dd, Dd, Dd, Dd, Dd, Dd^Vda, Dd, Dd, Dd, Dd, Dd
Wog, Wog, Wog, Wog, Wog, Wog, Wog, Wog, Wog, Wog, Wog, Wog, Wog, Wog, Wog, Gg, Gs^Fds, Gs^Fds, Gs, Gs^Vh, Gs^Ecf, Wwg, Gs^Vh, Co, Co, Co, Co, Wwg, Wwg, Gs, Gs, Gs, Gs, Md, Md, Hhd, Hhd, Md, Gs, Gs^Vh, Gs, Ds, Wog, Wog, Wog, Wog, Wog, Wog, Wog, Wog, Wog, Wog, Wog, Wog, Wog, Wog, Wog, Wog, Wog, Wog, Wog, Wog, Ds, Dd, Dd, Dd, Dd, Dd, Dd, Dd, Dd, Dd, Dd, Dd^Vda, Dd^Vda, Dd^Vda, Dd, Dd, Dd, Dd
Wog, Wog, Wog, Wog, Wog, Wog, Wog, Wog, Wog, Wog, Wog, Wog, Wog, Wog, Wog, Gg, Gs^Fds, Gs^Fds, Gs, Gs^Vh, Gs^Vh, Wwg, Gs^Vh, Gs^Ecf, Gs^Vh, Co, Gs^Vh, Gs^Vh, Gs, Wwg, Gs, Gs, Gs, Hhd, Hhd, Hhd, Md, Md, Gs, Gs, Gs, Ds, Wog, Wog, Wog, Wog, Wog, Wog, Wog, Wog, Wog, Wog, Wog, Wog, Wog, Wog, Wog, Wog, Wog, Wog, Wog, Wog, Ds, Dd, Dd, Dd, Dd, Dd, Dd, Dd, Dd, Dd, Dd^Vda, Dd^Vda, Xom, Rr^Pr|, Xom, Dd, Dd, Dd
Wog, Wog, Wog, Wog, Wog, Wog, Wog, Wog, Wog, Wog, Wog, Wog, Wog, Wog, Gg, Gg, Gs^Fds, Gs^Fds, Gs, Gs, Gs, Wwg, Gs, Gs^Vh, Gs^Vh, Gs^Ecf, Gs^Vh, Gs^Vh, Gs, Wwg, Gs, Gs, Gs, Hhd, Md, Hhd, Hhd, Hhd, Gs, Gs, Gs, Ds, Wog, Wog, Wog, Wog, Wog, Wog, Wog, Wog, Wog, Wog, Wog, Wog, Wog, Wog, Wog, Wog, Wog, Wog, Wog, Wog, Ds, Dd, Dd, Dd, Dd, Dd, Dd, Dd, Dd, Dd, Dd, Dd, Rr^Pr\, Dd^Vda, Rr^Pr/, Dd, Dd, Dd
Wog, Wog, Wog, Wog, Wog, Wog, Wog, Wog, Wog, Wog, Wog, Wog, Wog, Wog, Gg, Gg, Gs^Fds, Gs^Fds, Gs, Gs, Gs, Wwg, Gs, Gs, Gs, Gs^Vh, Gs, Gs, Gs, Wwg, Gs, Gs, Gs, Hhd, Hhd, Hhd, Hhd, Hhd, Md, Md, Hhd, Ds, Ds, Wog, Wog, Wog, Ds, Wog, Wog, Wog, Wog, Wog, Wog, Wog, Wog, Wog, Wog, Wog, Wog, Wog, Wog, Wog, Ds, Dd, Dd, Dd, Dd, Dd, Dd, Dd, Dd, Dd, Dd, Dd, Dd, Xom, Dd, Dd, Dd, Dd
Wog, Wog, Wog, Wog, Wog, Wog, Wog, Wog, Wog, Wog, Wog, Wog, Wog, Wog, Gg, Gg, Gs^Fds, Gs^Fds, Gs, Gs, Gs, Wwg, Wwg, Gs, Gs, Gs, Gs, Gs, Gs, Wwg, Gs, Gs, Gs, Hhd, Hhd, Md, Hhd, Hhd, Hhd, Hhd, Md, Hhd, Hhd, Ds, Ds, Ds, Ds, Wog, Wog, Wog, Wog, Wog, Wog, Wog, Wog, Wog, Wog, Wog, Wog, Wog, Wog, Wog, Ds, Dd, Dd, Dd, Dd, Dd, Dd, Dd, Dd, Dd, Dd, Dd, Dd, Dd, Dd, Dd, Dd, Dd
Wog, Wog, Wog, Wog, Wog, Wog, Wog, Wog, Wog, Wog, Wog, Wog, Wog, Wog, Gg, Gg, Gs^Fds, Gs^Fds, Gs, Gs, Gs, Gs, Wwg, Gs, Gs, Gs, Wog, Gs, Gs, Wwg, Gs^Vh, Gs, Gs^Ebn, Hhd, Hhd, Hhd, Hhd, Hhd, Hhd, Hhd, Hhd, Md, Md, Hhd, Gs, Gs, Ds, Wog, Wog, Wog, Wog, Wog, Wog, Wog, Wog, Wog, Wog, Wog, Wog, Wog, Wog, Wog, Ds, Dd, Dd, Dd, Dd, Dd, Dd, Dd, Dd, Dd, Dd, Dd, Dd, Dd, Dd, Dd, Dd, Dd
Wog, Wog, Wog, Wog, Wog, Wog, Wog, Wog, Wog, Wog, Wog, Wog, Wog, Gg, Gg, Gs^Fds, Gs^Fds, Dd, Gs, Gs, Gs, Gs, Gs, Wwg, Gs, Gs, Wog, Gs, Gs^Vh, Wwg, Gs^Vh, Gs^Vh, Gs^Vh, Gs^Wm, Md, Md, Md, Md, Md, Hhd, Hhd, Hhd, Wwg, Hhd, Hhd, Gs, Ds, Wog, Wog, Wog, Wog, Wog, Wog, Wog, Wog, Wog, Wog, Wog, Wog, Wog, Wog, Wog, Ds, Dd, Dd, Dd, Dd, Dd, Cd, Dd, Cd, Dd, Dd, Dd, Dd, Dd, Dd, Dd, Dd, Dd
Wog, Wog, Wog, Wog, Wog, Wog, Wog, Wog, Ch^Xo, Ch^Xo, Ch^Xo, Wog, Wog, Gg, Gs^Fds, Gs^Fds, Gs^Fds, Dd, Xu, Xu, Xu, Gs, Gs, Wwg, Gs, Gs, Wog, Gs, Gd^Vhr, Wwg, Cdr, Xos, Cd, Gs^Vh, Md, Md, Md, Md, Mdd, Md, Md, Hhd, Wwg, Wwg, Hhd, Hhd, Hhd, Ds, Ds, Wog, Wog, Wog, Wog, Wog, Wog, Wog, Wog, Wog, Wog, Wog, Wog, Wog, Ds, Dd, Dd, Dd, Dd^Vda, Cd, Cd, Cd, Cd, Cd, Dd, Dd, Dd, Dd, Dd, Dd, Dd, Dd
Wog, Wog, Wog, Wog, Wog, Wog, Ch^Xo, Ch^Xo, Rr^Vhc, Rr^Vhc, Ch^Xo, Wog, Rr^Vhc, Cd, Cd, Gs^Fds, Dd, Dd, Xu, Kud^Vov, Xu, Gs, Gs, Wwg, Gs, Gs, Gs^Vh, Gs^Vh, Cdr, Wwg, Xos, 8 Kd, Xos, Cd, Mdd, Md, Mdd, Mdd, Mdd, Mdd, Mdd, Md, Wwg, Wwg, Hhd, Hhd, Hhd, Gs, Gs, Ds, Ds, Wog, Ds, Wog, Wog, Wog, Wog, Wog, Wog, Wog, Wog, Wog, Ds, Dd, Dd, Dd^Vda, Dd^Do, Cd, Cd, 7 Kd, Cd, Cd, Dd^Vda, Dd, Dd, Dd, Dd, Dd, Dd, Dd
Wog, Wog, Wog, Wog, Ch^Xo, Ch^Xo, Rr^Vhc, Rr^Vhc, Rr^Vhc, Rr^Vhc, Ch^Xo, Wog, Rr^Vhc, Rr^Vhc, Rr^Vhc, Cd, Cd, Dd, Gs, Rr^Pw|, Gs, Gs, Gs, Wwg, Wwg, Gs, Gd^Vhr, Gs^Vh, Cd, Wwg, Chw, Cd, Cdr, Cdr, Dd^Wm, Mdd, Mdd, Mdd, Mdd, Mdd, Mdd, Md, Hhd, Hhd, Hhd, Hhd, Hhd, Gs, Md, Gs, Gs, Ds, Gs, Ds, Ds, Wog, Wog, Wog, Wog, Wog, Wog, Wog, Ds, Dd, Dd, Dd^Vda, Dd^Vda, Dd^Vda, Dd^Vda, Cd, Dd^Vda, Dd^Do, Dd^Vda, Dd, Dd, Dd, Dd, Dd, Dd, Dd
Wog, Wog, Ch^Xo, Ch^Xo, Rr^Vhc, Rr^Vhc, Rr^Vhc, Rr^Vhc, Ch^Xo, Ch^Xo, Wog, Wog, Wo, Rr^Vhc, Rr^Vhc, Rr^Vhc, Cd, Dd, Wog, Gs, Gs, Gs, Gs, Gs, Gs, Wwg, Wwg, Dd^Vda, Dd^Vda, Cd, Cdr, Wo, Wo, Wo, Wo, Dd^Ebn, Dd, Mdd, Mdd, Mdd, Hd, Hd, Md, Hhd, Hhd, Hhd, Hhd, Md, Md, Md, Md, Gs, Gs, Gs, Gs, Ds, Ds, Wog, Wog, Wog, Wog, Wog, Ds, Dd, Dd, Dd, Dd, Dd^Vda, Dd^Vda, Dd^Vda, Dd^Vda, Dd^Vda, Dd, Dd, Dd, Dd, Dd, Dd, Dd, Dd
Wog, Ch^Xo, Ch^Xo, Rr^Vhc, Rr^Vhc, Rr^Vhc, Ch^Xo, Ch^Xo, Wog, Wog, Wog, Wog, Rr^Vhc, Wo, Wo, Rr^Vhc, Cd, Wog, Wog, Gs, Gs, Gs, Gs, Gs, Gs, Gs, Wog, Dd^Vda, Dd^Ecf, Dd^Vdr, Dd^Vda, Dd^Vda, Dd^Vda, Dd^Wm, Dd, Wo, Wo, Dd, Dd, Hd, Mdd, Mdd, Mdd, Md, Hhd, Hhd, Hhd, Hhd, Hhd, Md, Md, Md, Md, Gs, Gs, Gs, Gs, Ds, Ds, Wog, Ds, Ds, Gs, Gs, Gs, Md, Md, Dd, Md, Dd, Dd, Dd, Dd, Dd, Dd, Dd, Dd, Dd, Dd, Dd
Wog, Wog, Wog, Ch^Xo, Ch^Xo, Ch^Xo, Wog, Wog, Wog, Wog, Wog, Rr^Vhc, Ch, Ch, Ch, Chw, Chw, Wog, Wog, Gs, Gs, Gs, Dd, Gs, Dd, Dd, Wog, Dd^Vda, Dd^Vda, Dd^Vdr, Dd, Dd^Vdr, Dd, Dd^Ebn, Dd, Dd, Wo, Dd, Dd, Mdd, Mdd, Mdd, Mdd, Md, Hhd, Hhd, Md, Md, Hh^Vhh, Hh^Vhh, Hh^Vhh, Md, Md, Md, Md, Md, Md, Md, Md, Gs, Gs, Gs, Gs, Gs, Hhd, Gs, Gs, Md, Md, Dd, Dd, Dd, Dd, Dd, Dd, Dd, Dd, Dd, Dd, Dd
Wog, Wog, Wog, Wog, Wog, Wog, Wog, Wog, Wog, Wog, Ch, Ch, Rr^Vhc, 2 Kh, Ch, Rr^Vhc, Rr^Vhc, Cd, Dd, Dd, Dd, Dd, Dd, Dd, Dd, Dd^Ftd, Wog, Dd, Dd, Dd, Dd, Dd, Dd, Dd, Dd, Dd^Ftd, Dd^Ftd, Wo, Dd, Mdd, Mdd, Mdd, Mdd, Md, Hhd, Hhd, Hhd, Md, Hh^Vhh, Rr^Vd, Ch, Ch, Ch, 6 Kh, Md, Md, Md, Md, Md, Md, Md, Gs, Hhd, Hhd, Hhd, Hhd, Gs, Gs, Gs, Dd, Xom, Xom, Xom, Dd^Vda, Dd^Vda, Dd, Dd, Dd, Dd, Dd
Gg, Wog, Wog, Wog, Wog, Wog, Wog, Wog, Wog, Wog, Ch, Rr^Vhc, Rr^Vhc, Ch, Rr^Vhc, Rr^Vhc, Rr^Vhc, Cd, Dd, Dd, Dd, Dd, Dd, Dd, Dd^Ftd, Dd^Ftd, Wog, Dd^Ftd, Dd, Dd, Dd, Dd, Dd, Dd, Dd, Dd^Ftd, Dd^Ftd, Wo, Dd, Dd, Hd, Hd, Hd, Hd, Md, Hhd, Hhd, Hhd, Hh^Vhh, Hh^Vhh, Ch, Ch, Ch, Ch, Ch, Md, Hhd, Md, Hhd, Md, Hhd, Hhd, Hhd, Hhd, Hhd, Hhd, Hhd, Gs, Dd, Rr^Pr/, Dd^Vda, Dd^Vda, Rr^Pr/, Dd^Vdr, Dd^Vda, Dd^Vda, Dd, Dd, Mdd, Dd
Gg, Gg, Gg, Wog, Gg, Wog, Cd, Wog, Rr^Vhc, Rr^Vhc, Rr^Vhc, Ch, Ch, Ch, Rr^Vhc, Rr^Vhc, Cd, Cd, Hd, Dd, Dd, Dd, Dd, Dd, Dd^Ftd, Dd^Ftd, Wog, Dd^Ftd, Dd^Ftd, Dd, Dd, Dd, Dd, Dd, Dd, Dd^Ftd, Dd^Ftd, Wo, Dd, Dd, Mdd, Mdd, Mdd, Mdd, Md, Hhd, Hhd, Hhd, Md, Md, Wwg, Wwg, Wwg, Ch, Ch, Hh^Vhh, Hhd, Hhd, Hhd, Hhd, Hhd, Hhd, Hhd, Hhd, Hhd, Hhd, Hhd, Gs, Dd, Xom, Xom, Xom, Dd^Vda, Dd^Do, Dd^Vda, Dd^Vda, Dd, Mdd, Mdd, Mdd
Gg, Gs^Fds, Gs^Fds, Gg, Gg, Gg, Cd, Rr^Vhc, Rr^Vhc, Rr^Vhc, Rr^Vhc, Rr^Vhc, Rr^Vhc, Rr^Vhc, Cd, Cd, Hd, Hd, Hd, Hd, Hd, Dd, Dd, Dd, Dd^Ftd, Dd^Ftd, Wo, Dd^Ftd, Dd^Ftd, Dd, Dd, Dd, Dd, Dd, Dd, Dd^Ftd, Dd^Ftd, Wo^Bsb\, Dd, Dd, Mdd, Mdd, Mdd, Mdd, Mdd, Hhd, Hhd, Hhd, Hh^Vhh, Md, Wwg, Wwg, Hh^Vhh, Rr^Vd, Hh^Vhh, Hh^Vhh, Hhd, Hhd, Hhd, Hhd, Hhd, Hhd, Hhd, Hhd, Hhd, Hhd, Hhd, Gs, Dd, Dd, Dd, Dd, Dd^Vda, Dd^Vdt, Dd, Dd, Mdd, Mdd, Mdd, Mdd
Dd, Gs^Fds, Gs^Fds, Gs^Fds, Gs^Fds, Gs^Fds, Gs^Fds, Cd, Cd, Rr^Vhc, Cd, Rr^Vhc, Cd, Cd, Hd, Hd, Dd, Hd, Hd, Hd, Hd, Hd, Dd, Dd, Dd, Dd^Ftd, Wo, Dd^Ftd, Dd^Ftd, Dd^Ftd, Dd, Dd, Dd, Dd, Dd, Dd^Ftd, Wo, Wo, Dd, Dd, Dd, Mdd, Mdd, Mdd, Mdd, Hd, Hd, Hh^Vhh, Rr^Vd, Hh^Vhh, Hhd, Hhd, Md, Hh^Vhh, Hhd, Hhd, Hhd, Hhd, Hhd, Hhd, Hhd, Hhd, Hhd, Hhd, Hhd, Hhd, Hhd, Dd, Dd, Dd, Dd, Dd, Dd, Dd, Dd, Dd, Mdd, Mdd, Mdd, Mdd
Ds, Dd, Dd, Dd, Dd, Gs^Fds, Hd, Gs^Fds, Hd, Cd, Hd, Cd, Hd, Hd, Dd, Dd, Wog, Dd, Dd, Hd, Hd, Hd, Dd, Dd, Dd, Dd^Ftd, Dd^Ftd, Wo, Wo^Bsb/, Dd^Ftd, Dd^Ftd, Dd, Dd^Ftd, Dd^Ftd, Dd^Ftd, Dd^Ftd, Wo, Dd^Ftd, Dd^Ftd, Dd, Dd, Mdd, Mdd, Mdd, Hd, Hd, Mdd, Md, Md, Hh^Vhh, Hhd, Hhd, Hhd, Md, Md, Hhd, Hhd, Hhd, Hhd, Hhd, Hhd, Hhd, Hhd, Hhd, Hhd, Hhd, Hhd, Dd, Dd, Dd, Dd, Dd, Dd, Dd, Dd, Dd, Mdd, Mdd, Mdd, Mdd
Wog, Ds, Ds, Dd, Hd, Hd, Hd, Hd, Hd, Hd, Hd, Hd, Hd, Hd, Dd, Wog, Wog, Wog, Dd, Hd, Hd, Hd, Dd, Dd, Dd, Dd, Dd, Dd^Ftd, Dd^Ftd, Wo, Wo, Dd^Ftd, Wo, Dd^Ftd, Wo, Wo, Dd^Vda, Dd^Vda, Dd^Vda, Dd^Ftd, Dd, Mdd, Mdd, Mdd, Mdd, Hd, Hd, Mdd, Mdd, Md, Hd, Hhd, Hhd, Hhd, Hhd, Hhd, Md, Md, Hhd, Hhd, Hhd, Hhd, Hhd, Hhd, Hhd, Hhd, Hhd, Dd, Dd, Dd, Dd, Dd, Dd, Dd, Hd, Hd, Mdd, Mdd, Mdd, Mdd
Wog, Wog, Ds, Dd, Hd, Hd, Hd, Hd, Hd, Hd, Hd, Hd, Ds, Dd, Dd, Wog, Dd, Dd, Dd, Hd, Hd, Hd, Hd, Dd, Hd, Dd, Dd, Dd, Dd, Dd^Ftd, Dd^Ftd, Wo, Dd^Vda, Wo, Wo, Wo, Dd^Vda, Dd^Ecf, Dd^Vda, Dd^Ftd, Dd, Mdd, Mdd, Mdd, Mdd, Mdd, Hd, Hd, Hd, Hd, Mdd, Md, Md, Hhd, Hhd, Hhd, Hhd, Md, Hhd, Hhd, Hhd, Hhd, Hhd, Hhd, Hhd, Hhd, Hhd, Dd, Dd, Dd, Dd, Dd, Dd, Hd, Hd, Hd, Hd, Mdd, Mdd, Mdd
Wog, Wog, Wog, Ds, Dd, Hd, Hd, Hd, Hd, Hd, Ds, Ds, Wog, Ds, Ds, Dd, Dd, Dd, Hd, Hd, Hd, Hd, Hd, Hd, Hd, Hd, Hd, Dd, Dd, Dd, Dd, Dd^Vda, Dd^Vda, Dd^Vda, Wo, Wo, Wo^Bsb/, Dd^Vda, Dd^Vda, Dd^Ftd, Dd, Dd, Dd, Mdd, Dd, Hd, Mdd, Mdd, Mdd, Mdd, Mdd, Mdd, Mdd, Md, Mdd, Hhd, Md, Hhd, Hhd, Hhd, Hhd, Hhd, Hhd, Hhd, Hhd, Hhd, Hhd, Dd, Dd, Dd, Dd, Dd, Dd, Hd, Hd, Hd, Hd, Hd, Hd, Hd
Wog, Wog, Wog, Ds, Hd, Hd, Hd, Hd, Hd, Ds, Wog, Wog, Wog, Wog, Ds, Dd, Dd, Hd, Hd, Hd, Hd, Hd, Hd, Hd, Hd, Hd, Hd, Dd, Dd, Dd, Xos, Rr^Pr|o, Xos, Dd^Vda, Dd^Vda, Wo^Bsb/, Wo, Ds^Ebn, Ds^Wm, Dd^Ftd, Dd, Dd, Dd, Dd, Dd, Dd, Dd, Mdd, Mdd, Mdd, Mdd, Mdd, Mdd, Mdd, Hd, Hd, Mdd, Md, Md, Md, Md, Hhd, Md, Hhd, Hhd, Hhd, Dd, Dd, Dd, Dd, Dd, Dd, Dd, Hd, Hd, Hd, Hd, Hd, Hd, Hd
Wog, Wog, Wog, Ds, Dd, Hd, Hd, Hd, Ds, Ds, Wog, Wog, Ds, Ds, Ds, Dd, Dd, Hd, Hd, Hd, Hd, Hd, Hd, Hd, Hd, Hd, Hd, Dd, Dd, Dd, Rr^Pr\o, Dd^Vda, Rr^Pr/o, Dd^Ftd, Dd^Vda, Wo, Wo, Wo, Wog, Wog, Wog, Wog, Wog, Dd, Dd, Dd, Dd, Dd, Dd, Mdd, Mdd, Mdd, Mdd, Mdd, Hd, Hd, Mdd, Mdd, Mdd, Md, Md, Md, Md, Md, Mdd, Dd, Dd, Dd, Dd, Mdd, Dd, Dd, Mdd, Mdd, Hd, Hd, Hd, Hd, Hd, Hd
Wog, Wog, Wog, Ds, Dd, Hd, Ds, Ds, Wog, Wog, Wog, Wog, Ds, Dd, Dd, Dd, Dd, Hd, Hd, Hd, Hd, Hd, Hd, Hd, Hd, Hd, Hd, Hd, Dd, Dd, Dd^Br|, Xos, Dd, Dd^Wm, Ds^Ebn, Ds, Wog, Wog, Wog, Wog, Wog, Wog, Wog, Wog, Wog, Dd, Dd, Dd, Dd, Dd, Dd, Mdd, Hd, Hd, Mdd, Mdd, Mdd, Mdd, Mdd, Mdd, Mdd, Mdd, Mdd, Mdd, Mdd, Mdd, Mdd, Dd, Dd, Mdd, Mdd, Dd, Mdd, Mdd, Hd, Hd, Hd, Hd, Hd, Hd
Wog, Wog, Wog, Ds, Dd^Vdt, Dd^Vdt, Ds, Ds, Wog, Wog, Ds, Ds, Dd, Dd, Dd, Dd, Dd, Hd, Hd, Hd, Hd, Hd, Hd, Hd, Hd, Hd, Hd, Hd, Dd, Dd, Dd^Br|, Dd, Dd, Ds, Wog, Wog, Wog, Wog, Wog, Wog, Wog, Wog, Wog, Wog, Wog, Wog, Dd, Dd, Dd, Dd, Dd, Dd, Dd, Mdd, Mdd, Mdd, Mdd, Mdd, Mdd, Mdd, Mdd, Mdd, Mdd, Mdd, Hd, Hd, Hd, Mdd, Dd, Dd, Dd, Mdd, Mdd, Mdd, Hd, Hd, Hd, Hd, Hd, Hd
Wog, Wog, Wog, Ds, Dd^Vdt, Dd^Vdt, Ds, Wog, Wog, Wog, Ds, Dd, Dd, Dd, Dd, Dd, Dd, Hd, Hd, Hd, Hd, Hd, Hd, Hd, Hd, Hd, Hd, Hd, Dd, Dd, Dd^Br|, Dd, Dd, Ds, Dd^Vdt, Wog, Wog, Wog, Ch, Wog, Wog, Wog, Wog, Wog, Wog, Wog, Wog, Dd, Dd, Dd, Dd, Dd, Dd, Dd, Dd, Dd, Dd, Mdd, Mdd, Mdd, Mdd, Mdd, Hd, Hd, Mdd, Mdd, Mdd, Hd, Dd, Dd, Dd, Mdd, Mdd, Hd, Hd, Hd, Hd, Hd, Hd, Hd
Wog, Wog, Wog, Ds, Ds, Ds, Wog, Wog, Wog, Wog, Ds, Dd, Dd, Dd, Dd, Dd, Dd, Hd, Hd, Hd, Hd, Hd, Hd, Hd, Hd, Hd, Hd, Hd, Hd, Dd, Dd^Br|, Dd, Dd^Vdt, Dd^Vdt, Dd^Vdt, Wog, Wog^Bw/, Ch, Ch, Ch, Ch, Wog, Wog, Wog, Ch, Wog, Wog, Wog, Wog, Dd, Dd, Dd, Dd, Dd, Dd, Dd, Dd, Dd, Dd, Dd, Dd, Mdd, Dd, Mdd, Mdd, Mdd, Mdd, Mdd, Mdd, Dd, Dd, Dd, Hd, Hd, Hd, Hd, Hd, Hd, Hd, Hd
Wog, Wog, Wog, Ds, Ds, Ds, Wog, Wog, Wog, Wog, Ds, Dd, Dd, Dd, Dd, Dd, Hd, Hd, Hd, Hd, Hd, Hd, Hd, Hd, Hd, Hd, Hd, Hd, Hd, Dd, Dd^Br|, Dd, Dd^Vdt, Dd^Vdt, Dd^Ecf, Dd^Vdt, Wog, Wog, 1 Kh, Ch, Ch, Ch, Wog^Cov, Ch, Gg^Vov, Ch, Ch, Wog, Wog, Wog, Dd, Dd, Dd, Dd, Dd, Dd, Dd, Dd, Dd, Dd, Dd, Dd, Dd, Mdd, Mdd, Mdd, Mdd, Mdd, Mdd, Mdd, Mdd, Hd, Hd, Hd, Hd, Hd, Hd, Hd, Hd, Hd
Dd^Xo, Wog, Wog, Wog, Wog, Wog, Wog, Wog, Wog, Wog, Ds, Dd, Dd, Dd, Dd, Dd, Dd, Hd, Hd, Hd, Hd, Hd, Hd, Hd, Hd, Hd, Hd, Hd, Hd, Hd, Hd^Br|, Dd, Dd, Dd^Vdt, Dd^Vdt, Dd^Vdt, Dd^Vdt, Wog, Wog, Rr^Vhc, Wog, Wog, Wog, Ch, Ch, Gg^Vov, Ch^Ebn, Ch, Wog, Wog, Wog, Dd, Dd, Dd, Dd, Dd, Dd, Dd, Wog, Dd, Dd, Dd, Dd, Mdd, Mdd, Mdd, Mdd, Mdd, Mdd, Mdd, Mdd, Hd, Hd, Hd, Hd, Hd, Hd, Hd, Hd, Hd
Dd^Xo, Wog, Wog, Wog, Wog, Wog, Wog, Wog, Wog, Wog, Wog, Ds, Ds, Dd, Dd, Dd, Dd, Hd, Hd, Hd, Hd, Hd, Hd, Hd, Hd, Hd, Hd, Hd, Hd, Hd, Hd^Br|, Dd, Dd, Dd^Vdt, Dd^Vdt, Dd^Vdt, Dd, Ds, Ds, Wog, Wog, Wog, Ds, Wog, Wog^Bw/, Ch, Ch, Ch, Wog, Wog, Wog, Wog, Dd, Dd, Dd, Dd, Wog, Wog, Wog, Wog, Wog, Dd, Dd, Mdd, Mdd, Mdd, Mdd, Mdd, Mdd, Mdd, Mdd, Hd, Hd, Hd, Hd, Hd, Hd, Hd, Hd, Hd
Dd^Xo, Dd^Xo, Wog, Wog, Wog, Wog, Wog, Wog, Wog, Wog, Wog, Wog, Ds, Dd, Dd, Dd, Dd, Hd, Hd, Hd, Hd, Hd, Hd, Hd, Hd, Hd, Hd, Hd, Hd, Hd, Hd^Br|, Dd, Dd, Dd, Dd, Dd, Dd, Ds, Ds, Wog^Bsb\, Wog^Bsb\, Ds, Ds, Ds, Wog, Wog, Wog, Wog, Wog, Wog, Ch^Xo, Wog, Wog, Dd, Wog, Wog, Wog, Wog, Dd, Wog, Wog, Wog, Dd, Dd, Dd, Mdd, Dd, Mdd, Mdd, Mdd, Dd, Hd, Hd, Hd, Hd, Hd, Dd^Vda, Dd^Vda, Hd, Hd
Dd^Xo, Dd^Xo, Wog, Wog, Wog, Wog, Wog, Wog, Wog, Wog, Wog, Wog, Ds, Dd, Dd, Dd, Dd, Hd, Hd, Hd, Hd, Hd, Hd, Hd, Hd, Hd, Hd, Hd, Hd, Hd, Hd^Br|, Hd, Dd, Dd, Dd^Wm, Dd, Dd, Ds, Wog, Wog, Wog, Ds, Ds, Wog, Wog, Wog, Wog, Wog, Ch^Xo, Ch^Xo, Rr^Vhc, Ch^Xo, Ch^Xo, Wog, Wog, Wog, Wog, Dd, Dd, Dd, Wog, Wog, Wog, Dd, Dd, Dd, Dd, Dd, Dd, Dd, Dd, Hd, Hd, Hd, Dd^Vda, Dd^Vda, Hd^Ecf, Dd^Vda, Dd^Vda, Hd
Dd^Xo, Dd^Xo, Wog, Wog, Wog, Wog, Wog, Wog, Wog, Wog, Wog, Wog, Wog, Ds, Ds, Dd, Dd, Dd, Dd, Hd, Hd, Hd, Hd, Hd, Hd, Hd, Hd, Hd, Hd, Hd, Hd^Br|, Hd, Dd, Dd, Dd, Dd^Ebn, Dd, Ds, Wog, Wog, Wog, Wog, Wog, Wog, Wog, Wog, Wog, Ch^Xo, Ch^Xo, Rr^Vhc, Rr^Vhc, Rr^Vhc, Rr^Vhc, Ch^Xo, Ch^Xo, Wog, Wog, Dd, Dd, Dd, Wog, Wog, Wog, Dd, Dd, Dd, Dd, Dd, Dd, Dd, Dd, Hd, Hd, Hd, Rr^Pr/, Xom, Rr^Pr\o, Dd^Vda, Dd^Vda, Hd
Dd^Xo, Dd^Xo, Wog, Wog, Wog, Wog, Wog, Wog, Wog, Wog, Wog, Wog, Wog, Wog, Ds, Dd, Dd, Dd, Dd, Hd, Hd, Hd, Hd, Hd, Hd, Hd, Hd, Hd, Hd, Hd, Hd^Br|, Hd, Dd, Dd, Dd, Dd, Dd, Ds, Wog, Wog, Wog, Wog, Wog, Wog, Ds^Ebn, Ds^Wm, Ds, Wog, Wog, Ch^Xo, Ch^Xo, Rr^Vhc, Rr^Vhc, Rr^Vhc, Rr^Vhc, Ch^Xo, Ch^Xo, Wog, Wog, Wog, Wog, Wog, Wog, Wog, Dd, Dd, Dd, Dd, Dd, Dd, Dd, Dd, Dd, Xom, Rr^Pr\, Dd^Vda, Xom, Dd^Vda, Dd, Dd
Dd^Xo, Dd^Xo, Wog, Wog, Wog, Wog, Wog, Wog, Wog, Wog, Wog, Wog, Wog, Wog, Wog, Ds, Ds, Dd, Dd, Hd, Hd, Hd, Hd, Hd, Hd, Hd, Hd, Hd, Hd^Br\, Hd, Hd^Br|, Hd, Dd, Dd, Dd^Wm, Dd, Dd, Ds, Wog, Wog, Wog, Wog, Ds^Ebn, Ds^Wm, Rr^Pr/, Xoi, Xoi, Wog, Wog, Wog, Wog, Ch^Xo, Ch^Xo, Rr^Vhc, Rr^Vhc, Rr^Vhc, Ch^Xo, Ch^Xo, Wog, Wog, Wog, Wog, Wog, Wog, Wog, Dd, Dd, Dd, Dd, Dd, Dd, Dd, Dd, Dd, Dd, Xom, Dd, Dd^Vda, Dd, Dd
Dd^Xo, Dd^Xo, Dd^Xo, Wog, Wog, Wog, Wog, Wog, Wog, Wog, Wog, Wog, Wog, Wog, Wog, Wog, Ds, Dd, Dd, Hd, Hd, Hd, Dd, Hd, Hd, Hd, Hd^Br/, Hd^Br/, Hd, Hd^Br\, Hd^Br\, Hd, Dd, Dd, Dd, Dd^Ebn, Dd, Ds, Wog, Wog, Wog, Wog, Ds, Xoi, Rr^Pr\o, Dd^Vda, Rr^Pr/, Wog, Wog, Wog, Wog, Wog, Wog, Ch^Xo, Ch^Xo, Ch^Xo, Wog, Wog, Wog, Wog, Wog, Wog, Wog, Wog, Wog, Wog, Wog, Dd, Wog, Dd, Dd, Dd, Dd, Dd, Dd, Dd, Wog, Dd, Wog, Wog
Dd^Xo, Dd^Xo, Dd^Xo, Wog, Wog, Wog, Wog, Wog, Wog, Wog, Wog, Wog, Wog, Wog, Wog, Wog, Ds, Dd, Dd, Hd, Hd, Hd, Hd, Hd, Hd^Br/, Hd^Br/, Dd^Vda, Dd^Vda, Dd^Vda, Dd^Vda, Cd, Hd^Br\, Hd^Br\, Dd, Dd, Dd, Dd, Ds, Ds, Wog, Wog, Wog, Dd^Vda, Dd^Vda, Dd^Vda, Xoi, Ds, Wog, Wog, Wog, Wog, Wog, Wog, Wog, Wog, Wog, Ds, Wog, Wog, Wog, Wog, Wog, Wog, Wog, Wog, Wog, Wog, Wog, Wog, Wog, Wog, Wog, Wog, Wog, Wog, Wog, Wog, Wog, Wog, Wog
Dd^Xo, Dd^Xo, Dd^Xo, Wog, Wog, Wog, Wog, Wog, Wog, Wog, Wog, Wog, Wog, Wog, Wog, Wog, Wog, Ds, Dd^Vda, Hd, Hd, Hd, Hd^Br/, Hd^Br/, Hd, Dd^Vda, Dd^Vda, Dd^Ecf, 3 Cd, Xoi, Cd, Cd, Cd, Hd^Br\, Hd^Br\, Dd, Dd^Br\, Ds^Ebn, Ds^Wm, Ds, Wog, Wog, Dd^Vda, Dd^Vda, Dd^Vda, Dd^Vda, Wog, Wog, Wog, Wog, Wog, Wog, Wog, Wog, Ds, Ds, Ds^Ebn, Ds, Ds, Wog, Wog, Wog, Wog, Wog, Wog, Wog, Wog, Wog, Wog, Wog, Wog, Wog, Wog, Wog, Wog, Wog, Wog, Wog, Wog, Wog
Dd^Xo, Dd^Xo, Dd^Xo, Wog, Wog, Wog, Wog, Wog, Wog, Wog, Wog, Wog, Wog, Wog, Wog, Wog, Ds, Ds, Rr^Pr|o, Dd^Vda, Dd^Vda, Hd^Br/, Hd, Hd, Hd, Dd^Vda, Dd^Vda, Dd^Do, Xoi, Kd, Xoi, Cd, Cd, Hd, Hd, Hd^Br/, Hd^Ebn, Dd^Br\, Dd^Br\, Ds, Ds, Ds, Dd^Vda, Dd^Vda, Dd^Vda, Dd^Vda, Wog, Wog, Wog, Wog, Wog, Wog, Wog, Wog, Ds, Ds^Wm, Dd^Vda, Ds, Ds, Wog, Wog, Wog, Wog, Wog, Wog, Wog, Wog, Wog, Wog, Wog, Ch^Xo, Ch^Xo, Ch^Xo, Wog, Wog, Wog, Wog, Wog, Wog, Wog
Dd^Xo, Dd^Xo, Dd^Xo, Wog, Wog, Wog, Wog, Wog, Wog, Wog, Wog, Wog, Wog, Wog, Wog, Wog, Ds, Xoi, Dd^Dc, Xoi, Dd^Vda, Hd, Hd, Hd, Hd, Dd^Do, Dd^Vda, Dd^Vda, Dd^Vda, Cd, Cd, Cd, Hd, Hd, Hd^Wm, Hd^Ebn, Hd, Dd^Wm, Dd, Dd^Br\, Dd^Br\, Dd, Dd^Br/, Dd^Vda, Ds, Ds, Wog, Wog, Wog, Wog, Wog, Wog, Wog, Wog, Ds^Wm, Dd^Vda, Dd^Ecf, Dd^Vda, Ds, Wog, Wog, Wog, Wog, Wog, Wog, Wog, Wog, Wog, Ch^Xo, Ch^Xo, Rr^Vhc, Rr^Vhc, Rr^Vhc, Ch^Xo, Ch^Xo, Ch^Xo, Ch^Xo, Wog, Wog, Wog
Dd^Xo, Dd^Xo, Dd^Xo, Wog, Wog, Wog, Wog, Wog, Wog, Wog, Wog, Wog, Wog, Wog, Wog, Wog, Ds, Rr^Pr\o, Xoi, Rr^Pr/o, Hd, Hd, Hd, Hd, Hd, Hd, Hd, Dd^Vda, Hd, Hd, Hd, Hd, Hd, Hd, Hd, Hd, Hd, Hd, Hd, Dd, Dd, Dd^Br\, Dd^Br\, Dd, Dd, Dd, Wog, Wog, Wog, Wog, Wog, Wog, Xoi, Cd, Cd, Dd^Vda, Dd^Vda, Dd^Vda, Dd, Wog, Wog, Wog, Wog, Wog, Wog, Wog, Wog, Wog, Wog, Ch^Xo, Ch^Xo, Rr^Vhc, Rr^Vov, Rr^Vhc, Kh^Vov, Kh^Vov, Kh^Vov, Ch^Xo, Wog, Wog
Dd^Xo, Dd^Xo, Dd^Xo, Dd^Xo, Dd^Xo, Wog, Wog, Wog, Wog, Wog, Wog, Wog, Wog, Wog, Wog, Wog, Ds, Dd^Vda, Dd^Vda, Dd^Vda, Dd, Hd, Hd, Hd, Hd, Hd, Hd, Hd, Hd, Hd, Hd, Hd, Hd, Hd, Hd, Hd, Hd, Hd, Hd, Hd, Dd, Dd, Dd, Dd^Br\, Dd^Br\, Dd, Dd, Ds, Ds, Ds, Cd, Cd, 4 Kd, Cd, Cd, Dd^Vda, Dd^Vda, Dd^Vda, Ds, Wog, Wog, Wog, Wog, Wog, Wog, Wog, Wog, Wog, Wog, Wog, Ch^Xo, Irs^Vov, Irs^Vov, Rr^Vhc, Kh^Vov, Kud^Vov, Kh^Vov, Ch^Xo, Ch^Xo, Wog
Dd^Xo, Dd^Xo, Dd^Xo, Dd^Xo, Dd^Xo, Wog, Wog, Wog, Wog, Wog, Wog, Wog, Wog, Wog, Wog, Wog, Wog, Ds, Ds, Dd, Dd, Hd, Hd, Hd, Hd, Hd, Hd, Hd, Hd, Hd, Hd, Hd, Hd, Hd, Hd, Hd, Hd, Hd, Hd, Hd, Dd, Dd, Dd, Dd, Dd, Dd^Br\, Dd^Br\, Ds^Wm, Dd^Ebn, Dd, Cd, Xoi, Cd, Xoi, Cd, Dd^Vda, Dd^Vda, Dd^Vda, Ds, Wog, Wog, Wog, Wog, Wog, Wog, Wog, Wog, Wog, Ch^Xo, Ch^Xo, Irs^Vov, Irs^Vov, Irs^Vov, Irs^Vov, Irs^Vov, Kh^Vov, Rr^Vhc, Rr^Vhc, Rr^Vhc, Ch^Xo
Dd^Xo, Dd^Xo, Dd^Xo, Dd^Xo, Dd^Xo, Wog, Wog, Wog, Wog, Wog, Wog, Wog, Wog, Wog, Wog, Wog, Wog, Wog, Ds, Dd, Dd, Dd, Hd, Hd, Hd, Hd, Hd, Hd, Hd, Hd, Hd, Hd, Hd, Hd, Hd, Hd, Hd, Hd, Hd, Hd, Dd, Dd, Dd, Dd, Dd, Dd, Dd, Dd^Br\, Dd^Br\, Dd^Wm, Dd^Ebn, Cd, Dd^Ebn, Cd, Dd^Vda, Dd^Vda, Dd^Ecf, Dd^Vda, Ds, Ds, Ds, Wog, Wog, Wog, Wog, Wog, Wog, Wog, Wog, Ch^Xo, Ch^Xo, Irs^Vov, Irs^Vov, Irs^Vov, Irs^Vov, Irs^Vov, Irs^Vov, Rr^Vhc, Ch^Xo, Ch^Xo
Dd^Xo, Dd^Xo, Dd^Xo, Dd^Xo, Dd^Xo, Wog, Wog, Wog, Wog, Wog, Wog, Wog, Wog, Wog, Wog, Wog, Wog, Wog, Wog, Ds, Dd, Dd, Hd, Hd, Hd, Hd, Hd, Hd, Hd, Hd, Hd, Hd, Hd, Hd, Hd, Hd, Hd, Hd, Hd, Hd, Dd, Dd, Dd, Dd, Dd, Dd, Dd, Dd, Dd, Dd^Br\, Dd^Br\, Dd^Wm, Dd, Dd^Br|, Dd^Ebn, Dd^Vda, Dd^Vda, Dd^Vda, Dd, Dd, Ds, Ds, Ds, Wog, Wog, Wog, Wog, Wog, Wog, Wog, Wog, Ch^Xo, Ch^Xo, Irs^Vov, Irs^Vov, Irs^Vov, Irs^Vov, Irs^Vov, Ch^Xo, Wog
Dd^Xo, Dd^Xo, Dd^Xo, Dd^Xo, Dd^Xo, Wog, Wog, Wog, Wog, Wog, Wog, Wog, Wog, Wog, Wog, Wog, Wog, Wog, Wog, Ds, Ds, Dd, Hd, Hd, Hd, Hd, Hd, Hd, Hd, Hd, Hd, Hd, Hd, Hd, Hd, Hd, Hd, Hd, Hd, Hd, Dd, Dd, Dd, Dd, Dd, Dd, Dd, Dd, Dd, Dd, Dd, Dd^Br\, Dd^Br\, Dd^Br|, Dd^Wm, Dd, Dd, Dd, Dd, Dd, Dd, Ds, Dd, Ds, Ds, Wog, Wog, Wog, Wog, Wog, Wog, Wog, Wog, Ch^Xo, Ch^Xo, Irs^Vov, Irs^Vov, Irs^Vov, Ch^Xo, Wog
Dd^Xo, Dd^Xo, Dd^Xo, Dd^Xo, Dd^Xo, Wog, Wog, Wog, Wog, Wog, Wog, Wog, Wog, Wog, Wog, Wog, Wog, Wog, Wog, Ds, Ds, Dd, Hd, Hd, Hd, Hd, Hd, Hd, Hd, Hd, Hd, Hd, Hd, Hd, Dd^Ftd, Hd, Dd^Vda, Hd, Hd, Hd, Dd, Dd, Dd, Dd, Dd, Dd, Dd, Dd, Dd, Dd, Dd, Dd, Dd, Dd^Br\, Dd, Dd, Dd, Dd, Dd, Dd, Dd, Dd, Ds, Ds, Wog, Wog, Wog, Wog, Wog, Wog, Wog, Wog, Wog, Wog, Wog, Ch^Xo, Ch^Xo, Ch^Xo, Wog, Wog
Dd^Xo, Dd^Xo, Dd^Xo, Dd^Xo, Dd^Xo, Dd^Xo, Wog, Wog, Wog, Wog, Wog, Wog, Wog, Wog, Wog, Wog, Wog, Wog, Wog, Ds, Ds, Dd, Dd, Hd, Hd, Hd, Hd, Hd, Hd, Hd, Hd, Hd, Hd, Hd, Dd^Vda, Dd^Do, Dd^Ftd, Dd^Ftd, Hd, Hd, Dd, Dd, Dd^Dc, Dd, Dd, Dd, Dd, Dd, Dd, Dd, Dd, Dd, Dd, Dd, Dd, Dd, Dd, Dd, Ds, Dd, Ds, Ds, Wog, Wog, Wog, Wog, Wog, Wog, Wog, Wog, Wog, Wog, Wog, Wog, Wog, Wog, Wog, Wog, Wog, Wog
Dd^Xo, Dd^Xo, Dd^Xo, Dd^Xo, Dd^Xo, Dd^Xo, Wog, Wog, Wog, Wog, Wog, Wog, Wog, Wog, Wog, Wog, Wog, Wog, Wog, Wog, Ds, Dd, Dd, Hd, Hd, Hd, Hd, Hd, Hd, Hd, Hd, Hd, Hd, Hd, Hd, Dd^Ftd, Hd, Hd, Hd, Hd, Dd, Dd, Dd, Dd, Dd, Dd, Dd, Dd, Dd, Dd, Dd, Dd, Dd, Dd, Dd, Dd, Dd, Dd, Ds, Ds, Wog, Wog, Wog, Wog, Wog, Wog, Wog, Wog, Wog, Wog, Wog, Wog, Wog, Wog, Wog, Wog, Wog, Wog, Wog, Wog
Dd^Xo, Dd^Xo, Dd^Xo, Dd^Xo, Dd^Xo, Dd^Xo, Dd^Xo, Wog, Wog, Wog, Wog, Wog, Wog, Wog, Wog, Wog, Wog, Wog, Wog, Wog, Wog, Ds, Dd, Mdd, Mdd, Hd, Mdd, Dd^Vdt, Dd^Do, Hd, Hd, Hd, Hd, Hd, Hd, Hd, Hd, Hd, Hd, Hd, Dd, Dd, Dd, Dd, Dd, Dd, Dd, Dd, Dd, Dd, Dd, Dd, Dd, Dd, Dd, Dd, Ds, Ds, Wog, Wog, Wog, Wog, Wog, Wog, Wog, Wog, Wog, Wog, Wog, Wog, Wog, Wog, Ch^Xo, Ch^Xo, Ch^Xo, Ch^Xo, Ch^Xo, Ch^Xo, Ch^Xo, Wog
Dd^Xo, Dd^Xo, Dd^Xo, Dd^Xo, Dd^Xo, Dd^Xo, Dd^Xo, Wog, Wog, Wog, Wog, Wog, Wog, Wog, Wog, Wog, Wog, Wog, Wog, Wog, Wog, Ds, Dd, Mdd, Mdd, Mdd, Mdd, Hd^Ecf, Dd^Vdt, Hd, Hd, Hd, Hd, Hd, Hd, Hd, Hd, Hd, Hd, Hd, Hd, Dd, Hd, Hd, Hd, Hd, Hd, Dd, Dd, Dd, Dd, Dd, Dd, Dd, Ds, Ds, Wog, Wog, Wog, Wog, Wog, Wog, Wog, Wog, Wog, Wog, Wog, Wog, Wog, Wog, Ch^Xo, Ch^Xo, Rr^Vhc, Rr^Vhc, Rr^Vhc, Rr^Vhc, Rr^Vhc, Rr^Vhc, Ch^Xo, Wog
Dd^Xo, Dd^Xo, Dd^Xo, Dd^Xo, Dd^Xo, Dd^Xo, Dd^Xo, Dd^Xo, Dd^Xo, Wog, Wog, Wog, Wog, Wog, Wog, Wog, Wog, Wog, Wog, Wog, Ds, Ds, Dd, Mdd, Mdd, Mdd, Mdd, Dd^Vdt, Hd, Hd, Hd, Hd, Hd, Hd, Hd, Hd, Hd, Hd, Hd, Hd, Hd, Hd, Dd^Vda, Hd, Dd^Vda, Hd, Hd, Dd, Dd, Dd, Dd, Dd, Ds, Ds, Wog, Wog, Wog, Wog, Wog, Wog, Wog, Wog, Wog, Wog, Wog, Wog, Wog, Wog, Ch^Xo, Ch^Xo, Rr^Vhc, Rr^Vhc, Rr^Vhc, Rr^Vhc, Rr^Vhc, Rr^Vhc, Rr^Vhc, Rr^Vhc, Ch^Xo, Wog
Dd^Xo, Dd^Xo, Dd^Xo, Dd^Xo, Dd^Xo, Dd^Xo, Dd^Xo, Dd^Xo, Dd^Xo, Wog, Wog, Wog, Wog, Wog, Wog, Wog, Wog, Wog, Wog, Wog, Ds, Dd, Dd^Vda, Mdd, Mdd, Mdd, Mdd, Mdd, Hd, Hd, Hd, Hd, Hd, Hd, Dd, Hd, Hd, Hd, Hd, Hd, Hd, Hd, Dd^Vda, Dd^Vda, Dd^Vda, Hd, Dd, Dd, Dd, Dd, Ds, Ds, Wog, Wog, Wog, Wog, Wog, Wog, Wog, Wog, Wog, Wog, Wog, Wog, Wog, Wog, Kh^Xo, Kh^Xo, Rr^Vhc, Rr^Vhc, Rr^Vhc, Rr^Vhc, Rr^Vhc, Rr^Vhc, Rr^Vhc, Rr^Vhc, Rr^Vhc, Ch^Xo, Wog, Wog
Dd^Xo, Dd^Xo, Dd^Xo, Dd^Xo, Dd^Xo, Dd^Xo, Dd^Xo, Dd^Xo, Dd^Xo, Wog, Wog, Wog, Wog, Wog, Wog, Wog, Wog, Wog, Wog, Wog, Ds, Dd, Dd, Dd^Ecf, Dd, Mdd, Dd, Mdd, Dd, Hd, Ds, Dd, Dd, Dd, Dd, Dd, Dd, Dd, Dd, Hd, Dd, Dd^Vda, Ds, Dd^Vda, Dd^Vda, Dd, Ds, Ds, Ds, Ds, Wog, Wog, Wog, Wog, Wog, Wog, Wog, Wog, Wog, Wog, Wog, Wog, Wog, Wog, Ch^Xo, Kh^Xo, Rr^Vhc, Rr^Vhc, Rr^Vhc, Rr^Vhc, Rr^Vhc, Rr^Vhc, Rr^Vhc, Rr^Vhc, Rr^Vhc, Rr^Vhc, Ch^Xo, Ch^Xo, Wog, Wog
Dd^Xo, Dd^Xo, Dd^Xo, Dd^Xo, Dd^Xo, Dd^Xo, Dd^Xo, Dd^Xo, Dd^Xo, Dd^Xo, Wog, Wog, Wog, Wog, Wog, Wog, Wog, Wog, Wog, Wog, Ds, Dd, Ds, Dd^Vda, Ds, Ds, Ds, Ds, Ds, Ds, Ds, Ds, Ds, Ds, Ds, Ds, Ds, Ds, Ds, Ds, Ds, Ds, Ds, Ds, Ds, Ds, Wog, Ds, Wog, Wog, Wog, Wog, Wog, Wog, Wog, Wog, Wog, Wog, Wog, Wog, Wog, Wog, Ch^Xo, Ch^Xo, Rr^Vhc, Rr^Vhc, Rr^Vhc, Rr^Vhc, Rr^Vhc, Rr^Vhc, Rr^Vhc, Rr^Vhc, Rr^Vhc, Rr^Vhc, Ch^Xo, Ch^Xo, Wog, Wog, Wog, Wog
Dd^Xo, Dd^Xo, Dd^Xo, Dd^Xo, Dd^Xo, Dd^Xo, Dd^Xo, Dd^Xo, Dd^Xo, Dd^Xo, Wog, Wog, Wog, Wog, Wog, Wog, Wog, Wog, Wog, Wog, Wog, Ds, Wog, Ds, Wog, Wog, Wog, Wog, Wog, Wog, Wog, Wog, Wog, Wog, Wog, Wog, Wog, Wog, Wog, Wog, Wog, Wog, Wog, Wog, Wog, Wog, Wog, Wog, Wog, Wog, Wog, Wog, Wog, Wog, Wog, Wog, Wog, Wog, Wog, Wog, Wog, Wog, Ch^Xo, Rr^Vhc, Rr^Vhc, Rr^Vhc, Rr^Vhc, Rr^Vhc, Rr^Vhc, Rr^Vhc, Rr^Vhc, Rr^Vhc, Ch^Xo, Ch^Xo, Wog, Wog, Wog, Wog, Wog, Wog
Dd^Xo, Dd^Xo, Dd^Xo, Dd^Xo, Dd^Xo, Dd^Xo, Dd^Xo, Dd^Xo, Dd^Xo, Dd^Xo, Wog, Wog, Wog, Wog, Wog, Wog, Wog, Wog, Wog, Wog, Wog, Wog, Wog, Wog, Wog, Wog, Wog, Wog, Wog, Wog, Wog, Wog, Wog, Wog, Wog, Wog, Wog, Wog, Wog, Wog, Wog, Wog, Wog, Wog, Wog, Wog, Wog, Wog, Wog, Wog, Wog, Wog, Wog, Wog, Wog, Wog, Wog, Wog, Wog, Wog, Wog, Wog, Ch^Xo, Rr^Vhc, Rr^Vhc, Rr^Vhc, Rr^Vhc, Rr^Vhc, Rr^Vhc, Rr^Vhc, Ch^Xo, Ch^Xo, Wog, Wog, Wog, Wog, Wog, Wog, Wog, Wog
Gg^Xo, Dd^Xo, Dd^Xo, Dd^Xo, Dd^Xo, Dd^Xo, Dd^Xo, Dd^Xo, Dd^Xo, Dd^Xo, Wog, Wog, Wog, Wog, Wog, Wog, Wog, Wog, Wog, Wog, Wog, Wog, Wog, Wog, Wog, Wog, Wog, Wog, Wog, Wog, Wog, Wog, Wog, Wog, Wog, Wog, Wog, Wog, Wog, Wog, Wog, Wog, Wog, Wog, Wog, Wog, Wog, Wog, Wog, Wog, Wog, Wog, Wog, Wog, Wog, Wog, Wog, Wog, Wog, Wog, Wog, Wog, Ch^Xo, Ch^Xo, Ch^Xo, Ch^Xo, Ch^Xo, Ch^Xo, Ch, Ch^Xo, Wog^Qov, Wog, Wog, Wog, Wog, Wog, Wog, Wog, Wog, Wog
