Wo, Wo, Wo, Wo, Wo, Wo, Wo, Wo, Wo, Wo, Wo, Wo, Wo, Wo, Wo, Wo, Wo, Wo, Wo, Wo, Wo, Wo, Wo, Wo, Wo, Wo, Wo, Wo, Wo, Wo, Wo, Wo, Wo, Wo, Wo, Wo, Wo, Wo, Wo, Wo, Wo, Wo, Wo, Wo, Ms, Ms, Ms, Ms, Ms, Ms, Ms, Ms, Ha^Fpa, Ha, Rb, Ha, Ha, Aa^Fpa, Aa^Fpa, Ha, Ai, Aa^Fpa, Ai, Aa^Fpa, Ai, Aa^Fpa, Aa^Fpa, Aa^Fpa, Ai, Aa^Fpa, Aa^Fpa, Aa^Fpa, Ai, Aa^Fpa, Aa^Fpa, Aa, Aa, Aa^Fpa, Aa^Fpa, Aa, Aa, Aa^Fpa, Aa, Aa, Aa, Aa, Aa^Fpa, Aa, Aa^Fpa, Aa, Aa, Aa
Wo, Wo, Wo, Wo, Wo, Wo, Wo, Wo, Wo, Wo, Wo, Wo, Wo, Wo, Wo, Wo, Wo, Wo, Wo, Wo, Wo, Wo, Wo, Wo, Wo, Wo, Wo, Wo, Wo, Wo, Wo, Wo, Wo, Wo, Wo, Wo, Wo, Wo, Wo, Wo, Wo, Wo, Wo, Wo, Wo, Wo, Ms, Ms, Ms, Ms, Ms, Ms, Ha, Ha, Ha, Rb, Rb, Aa^Fpa, Aa^Fpa, Aa^Fpa, Ai, Ai, Ai, Ai, Aa^Fpa, Aa^Fpa, Aa^Fpa, Aa^Fpa, Aa^Fpa, Aa^Fpa, Ai, Aa^Fpa, Aa^Fpa, Aa^Fpa, Aa, Aa, Aa, Aa, Aa, Aa, Aa, Aa^Fpa, Ai, Aa, Aa, Aa^Fpa, Aa^Fpa, Aa^Fpa, Aa^Fpa, Aa, Aa^Fpa, Aa
Wo, Wo, Wo, Wo, Wo, Wo, Wo, Wo, Wo, Wo, Wo, Wo, Wo, Wo, Wo, Wo, Wo, Wo, Wo, Wo, Wo, Wo, Wo, Wo, Wo, Wo, Wo, Wo, Wo, Wo, Wo, Wo, Wo, Wo, Wo, Wo, Wo, Wo, Wo, Wo, Wo, Wo, Wo, Aa^Fpa, Wo, Ms, Ms, Ms, Ms, Ms, Ms, Ms, Ha, Aa^Fpa, Aa^Fpa, Aa^Fpa, Aa^Fpa, Rb, Rb, Aa^Fpa, Ai, Ai, Aa^Fpa, Aa^Fpa, Aa^Fpa, Aa^Fpa, Aa^Fpa, Aa^Fpa, Ai, Aa^Fpa, Ai, Aa^Fpa, Ai, Aa^Fpa, Aa, Aa, Aa^Fpa, Aa^Fpa, Aa^Fpa, Aa, Aa, Aa, Ai, Aa, Aa, Aa, Aa, Aa, Aa, Aa, Aa, Aa^Fpa
Wo, Wo, Wo, Wo, Wo, Wo, Wo, Wo, Wo, Wo, Wo, Wo, Wo, Wo, Wo, Wo, Wo, Wo, Wo, Wo, Wo, Wo, Wo, Wo, Wo, Wo, Wo, Wo, Wo, Wo, Wo, Wo, Wo, Wo, Wo, Wo, Wo, Wo, Wo, Wo, Wo, Aa^Fpa, Wo, Wo, Ms, Ms, Ms, Ms, Ms, Ms, Ha, Ha^Fpa, Ha^Fpa, Aa^Fpa, Aa^Vha, Aa^Fpa, Rb, Rb, Ai, Rb, Aa, Aa, Aa^Fpa, Aa^Fpa, Aa^Fpa, Aa^Fpa, Ai, Aa^Fpa, Aa^Fpa, Aa^Fpa, Aa^Fpa, Aa^Fpa, Aa^Fpa, Aa^Fpa, Aa, Aa^Fpa, Aa^Fpa, Aa^Fpa, Aa^Fpa, Aa^Fpa, Aa^Fpa, Ai, Ai, Ai, Ai, Ai, Aa, Aa, Aa^Fpa, Aa, Aa^Fpa, Aa^Fpa
Wo, Wo, Wo, Wo, Wo, Wo, Wo, Wo, Wo, Wo, Wo, Wo, Wo, Wo, Wo, Wo, Wo, Wo, Wo, Wo, Wo, Wo, Wo, Wo, Wo, Wo, Wo, Wo, Wo, Wo, Wo, Wo, Wo, Wo, Wo, Wo, Wo, Wo, Wo, Wo, Wo, Wo, Ms, Ms, Ms, Ms, Ms, Ms, Ms, Ms, Ha^Fpa, Ha, Ha, Ha, Ha, Rb, Ai, Ai, Ai, Rb, Rb, Aa, Aa^Fpa, Aa^Fpa, Aa^Fpa, Aa^Fpa, Aa^Fpa, Aa^Fpa, Aa^Fpa, Aa^Fpa, Aa^Fpa, Ai, Aa^Fpa, Aa^Fpa, Aa, Aa^Fpa, Ai, Ai, Ai, Aa^Fpa, Ai, Aa, Aa, Ai, Ai, Ai, Aa, Aa^Fpa, Aa^Fpa, Aa, Aa, Aa
Wo, Wo, Wo, Wo, Wo, Wo, Wo, Wo, Wo, Wo, Wo, Wo, Wo, Wo, Wo, Wo, Wo, Wo, Wo, Wo, Wo, Wo, Wo, Wo, Wo, Wo, Wo, Wo, Wo, Wo, Wo, Wo, Wo, Wo, Wo, Wo, Wo, Wo, Wo, Wo, Ms, Ms, Ms, Ms, Ms, Ms, Ms, Ms, Ms, Ms, Ha, Ha, Aa^Fpa, Aa^Fpa, Rb, Rb, Ai, Wo, Ai, Aa, Aa, Rb, Aa^Fpa, Aa^Fpa, Aa^Fpa, Aa^Fpa, Rb, Rb, Rb, Aa^Fpa, Rb, Aa^Fpa, Rb, Aa, Aa, Aa^Fpa, Rb, Ai, Ai, Ai, Ai, Ai, Aa, Aa, Ai, Aa, Aa, Aa^Fpa, Aa^Fpa, Aa, Aa, Aa
Wo, Wo, Wo, Wo, Wo, Wo, Wo, Wo, Wo, Wo, Wo, Wo, Wo, Wo, Wo, Wo, Wo, Wo, Wo, Wo, Wo, Wo, Wo, Wo, Wo, Wo, Wo, Wo, Wo, Wo, Wo, Wo, Hh, Hh^Fp, Wo, Wo, Wo, Wo, Wo, Ms, Ms, Ms, Ms, Ms, Ms, Ms, Ms, Ms, Ms, Ms, Ha, Ha^Fpa, Ha, Aa^Fpa, Rb, Ai, Wo, Wo, Wo, Aa, Aa, Rb, Rb, Aa^Fpa, Rb, Rb, Ai, Aa^Fpa, Ai, Rb, Ai, Rb, Aa^Vha, Rb, Rb, Rb, Aa, Rb, Rb, Ai, Ai, Aa, Aa^Fpa, Aa^Fpa, Aa, Aa, Aa^Fpa, Aa^Fpa, Aa^Fpa, Aa^Fpa, Aa, Aa^Fpa
Wo, Wo, Wo, Wo, Wo, Wo, Wo, Wo, Wo, Wo, Wo, Wo, Wo, Wo, Wo, Wo, Wo, Wo, Wo, Wo, Wo, Wo, Wo, Wo, Wo, Wo, Wo, Wo, Wo, Wo, Wo, Wo, Hh^Fp, Hh, Wo, Wo, Wo, Wo, Wo, Ms, Ms, Ms, Ms, Ms, Ms, Ms, Ms, Ms, Ms, Ha^Fpa, Ha, Ha, Ha, Ha, Rb, Ai, Wo, Wo, Wo, Wo, Aa, Aa, Aa, Rb, Ha, Aa^Fpa, Aa, Aa^Fpa, Aa, Aa, Wo, Aa, Wo, Aa, Aa, Aa, Wo, Aa, Rb, Ai, Aa, Aa, Aa^Fpa, Aa^Fpa, Aa, Aa, Aa^Fpa, Aa^Fpa, Aa, Aa^Fpa, Aa, Aa^Fpa
Wo, Wo, Wo, Wo, Wo, Wo, Wo, Wo, Wo, Wo, Wo, Wo, Wo, Wo, Wo, Wo, Wo, Wo, Wo, Wo, Wo, Wo, Wo, Wo, Wo, Wo, Wo, Wo, Wo, Wo, Wo, Wo, Wo, Wo, Wo, Wo, Wo, Wo, Wo, Ms, Ms, Ms, Ms, Ms, Ms, Ms, Ms, Ms, Ha, Ha, Aa^Fpa, Aa^Fpa, Aa^Fpa, Ha, Rb, Ha, Ha, Wo, Wo, Wo, Aa, Aa, Cha, Kha^Vov, Cha, Ha, Wo, Aa, Wo, Wo, Wo, Wo, Wo, Wo, Wo, Wo, Wo, Wo, Aa, Rb, Aa^Fpa, Aa^Fpa, Aa^Fpa, Aa^Fpa, Aa^Fpa, Aa, Aa, Aa, Aa, Aa, Aa, Aa
Wo, Wo, Wo, Wo, Wo, Wo, Wo, Wo, Wo, Wo, Wo, Wo, Wo, Wo, Wo, Wo, Wo, Wo, Wo, Wo, Wo, Wo, Wo, Wo, Hh^Fp, Hh^Fp, Wo, Wo, Wo, Wo, Wo, Wo, Wo, Wo, Wo, Wo, Wo, Wo, Wo, Ms, Ms, Ms, Ms, Ms, Ms, Ms, Ms, Ms, Kha^Vov, Ha, Ha, Aa^Fpa, Ha, Aa^Fpa, Rb, Ha, Ha, Ha, Wo, Wo, Wo, Aa, Aa, Cha, Wo, Wo, Wo, Wo, Wo, Aa, Wo, Wo, Wo, Wo, Aa, Wo, Wo, Aa^Fpa, Re, Re, Re, Re, Re, Gll^Fp, Gll^Fp, Aa^Fpa, Gg, Gll^Fp, Gll^Fp, Gll^Fp, Gll^Fp, Gg
Wo, Wo, Wo, Wo, Wo, Wo, Wo, Wo, Wo, Wo, Wo, Wo, Wo, Wo, Wo, Wo, Wo, Wo, Wo, Wo, Wo, Wo, Hh, Hh, Hh, Hh, Wo, Wo, Hh^Fp, Hh, Wo, Hh, Wo, Wo, Wo, Wo, Wo, Wo, Wo, Ms, Ms, Ms, Ms, Ms, Ms, Ms, Rb, Cha, Cha, Cha, Rb, Ha, Rb, Rb, Ch, Ch, Ch, Ha, Wo, Wo, Wo, Wo, Wo, Wo, Wo, Wo, Wo, Wo, Wo, Wo, Wo, Wo, Wo, Wo, Gg, Wo, Re, Ket^Vh, Gg, Gll^Fp, Gll^Fp, Aa, Gg, Re, Aa^Fpa, Aa^Fpa, Aa^Fpa, Gll^Fp, Aa^Fpa, Gll^Fp, Gll^Fp, Gg
Wo, Wo, Wo, Wo, Wo, Wo, Wo, Wo, Wo, Wo, Wo, Wo, Wo, Wo, Wo, Wo, Wo, Wo, Wo, Wo, Wo, Wo, Hh, Hh, Wo, Wo, Hh^Fp, Hh, Gs^Vh, Wo, Wo, Wo, Wo, Wo, Wo, Wo, Wo, Wo, Wo, Ms, Aa^Fpa, Ms, Rb, Ms, Rb, Rb, Wo, Wo, Aa, Aa, Ai, Rb, Rb, Ha, Cha, Kha^Vov, Cha, Wo, Wo, Wo, Wo, Wo, Wo, Wo, Wo, Wo, Aa, Wo, Aa, Aa, Gg, Wo, Gg, Gll^Fp, Re, Re, Gll^Fp, Gll^Fp, Gll^Fp, Gg, Aa, Gll^Fp, Gll^Fp, Re, Re, Aa^Fpa, Gg, Gg, Gll^Fp, Gll^Fp, Gg, Gg
Wo, Wo, Wo, Wo, Wo, Wo, Wo, Wo, Wo, Wo, Wo, Wo, Wo, Wo, Wo, Wo, Wo, Wo, Wo, Wo, Wo, Wo, Hh, Hh, Wo, Hh, Hh, Re, Hh, Gg, Gg^Fp, Wo, Wo, Wo, Wo, Wo, Wo, Wo, Wo, Wo, Wo, Aa^Vha, Aa^Fpa, Rb, Wo, Wo, Wo, Wo, Aa, Ai, Aa^Fpa, Rb, Aa, Rb, Aa^Fpa, Cha, Wo, Wo, Wo, Wo, Wo, Wo, Wo, Wo, Aa, Aa, Gg, Aa, Wo, Gg, Gg, Gg, Gg, Gll^Fp, Re, Gll^Fp, Gll^Fp, Gll^Fp, Gg, Wo, Gg, Gg, Gg, Aa, Aa, Re, Gg, Gg, Aa, Gg, Aa, Gg
Wo, Wo, Wo, Wo, Wo, Wo, Wo, Wo, Wo, Wo, Wo, Wo, Wo, Wo, Wo, Wo, Wo, Wo, Wo, Wo, Wo, Wo, Wo, Wo, Hh, Hh^Fp, Re, Re, Gg, Gg, Wo, Wo, Wo, Wo, Wo, Wo, Wo, Wo, Wo, Wo, Wo, Wo, Wo, Wo, Wo, Wo, Wo, Wo, Aa^Vha, Rb, Rb, Rb, Aa, Aa, Aa, Wo, Wo, Wo, Wo, Wo, Wo, Wo, Aa, Wo, Wo, Gll^Fp, Gll^Fp, Gg, Wo, Gg, Gg, Gg, Gll^Fp, Gll^Fp, Re, Gll^Fp, Gll^Fp, Gll^Fp, Gll^Fp, Gg, Gg, Gll^Fp, Gg, Gg, Gg, Re, Gll^Fp, Gll^Fp, Gg, Aa, Gll^Fp, Gg
Wo, Wo, Wo, Wo, Wo, Wo, Wo, Wo, Wo, Wo, Wo, Wo, Wo, Wo, Wo, Wo, Wo, Wo, Gg, Wo, Wo, Wo, Wo, Wo, Hh^Fp, Hh, Re, Gll^Fp, Gg, Gg^Fp, Wo, Wo, Wo, Wo, Wo, Wo, Wo, Wo, Wo, Wo, Wo, Wo, Wo, Wo, Wo, Wo, Wo, Wo, Aa, Aa, Ai, Rb, Aa, Aa^Fpa, Aa^Fpa, Wo, Wo, Wo, Aa, Ai, Wo, Wo, Aa, Aa, Wo, Gg, Gll^Fp, Gg, Gg, Gg, Gg, Gll^Fp, Re, Re, Gg, Gg, Gll^Fp, Gll^Fp, Gll^Fp, Gg, Gg, Gg, Gg, Gll^Fp, Gg, Re, Gg, Gg, Gg, Gg, Gg, Gg
Wo, Wo, Wo, Wo, Wo, Wo, Wo, Wo, Wo, Wo, Wo, Wo, Wo, Wo, Hh, Wo, Hh, Hh, Hh, Gg, Gg, Ww, Gll^Fp, Gg, Gg, Re, Gg, Gg, Wo, Wo, Wo, Wo, Wo, Wo, Wo, Wo, Wo, Wo, Wo, Wo, Wo, Wo, Wo, Wo, Wo, Wo, Ww, Ww, Wwf, Aa^Fpa, Ai, Rb, Rb, Aa^Fpa, Aa^Fpa, Wo, Wo, Wo, Ai, Wo, Wo, Wo, Wo, Wo, Wo, Gg, Gg, Gg, Gs^Vh, Gg, Re, Re, Gg, Gg, Gll^Fp, Gll^Fp, Gll^Fp, Gll^Fp, Gll^Fp, Gll^Fp, Gll^Fp, Gg, Gg, Gg, Gg, Re, Gg, Gg^Fp, Gg, Gg, Gg, Gg
Wo, Wo, Wo, Wo, Wo, Wo, Wo, Wo, Wo, Wo, Wo, Wo, Wo, Hh, Hh, Hh, Hh, Hh, Re, Gg, Gg, Wwf, Gll^Fp, Gll^Fp, Gg, Gs^Vh, Gg, Gg^Fp, Gg, Wo, Wo, Wo, Wo, Wo, Wo, Wo, Wo, Wo, Wo, Wo, Wo, Wo, Wo, Wo, Aa^Fpa, Aa^Fpa, Aa, Wwf, Ww, Aa^Fpa, Aa^Fpa, Aa, Rb, Aa^Fpa, Aa, Aa^Fpa, Ai, Wo, Wo, Wo, Wo, Wo, Gg, Gg, Gg, Wo, Ket^Vh, Re, Gg, Re, Gll^Fp, Gg, Gg, Gll^Fp, Gg, Gll^Fp, Gll^Fp, Gll^Fp, Gll^Fp, Gll^Fp, Gll^Fp, Gg, Gg, Gg, Gg, Re, Gg, Gg, Gg, Gg, Gg, Gg
Wo, Wo, Wo, Wo, Wo, Wo, Wo, Wo, Wo, Wo, Wo, Wo, Wo, Hh, Hh, Hh, Re, Re, Gg, Gs^Vh, Wo, Ww, Wo, Gll^Fp, Gll^Fp, Gll^Fp, Re, Gg, Ket^Vh, Wo, Wo, Wo, Wo, Wo, Wo, Wo, Wo, Wo, Wo, Wo, Wo, Wo, Wo, Aa, Ch, Kh^Vov, Ch, Ww, Wo, Wo, Aa^Fpa, Aa^Fpa, Aa, Rb, Aa^Vha, Aa, Ai, Wo, Wo, Wo, Wo, Gg, Gll^Fp, Gg, Re, Re, Gg, Gg, Gll^Fp, Gll^Fp, Gll^Fp, Re, Gg, Gg, Gg, Gll^Fp, Gll^Fp, Gll^Fp, Gll^Fp, Gll^Fp, Gg, Gg, Gg, Gll^Fp, Ch, Ch, Ch, Gg^Fp, Gg, Gg^Fp, Gg, Gg
Wo, Wo, Wo, Wo, Wo, Wo, Wo, Wo, Wo, Wo, Wo, Wo, Wo, Hh, Hh, Hh, Re, Gg, Gll^Fp, Gll^Fp, Wo, Wo, Wo, Wo, Gg, Gll^Fp, Gg, Re, Gg, Wo, Wo, Wo, Wo, Wo, Wo, Wo, Wo, Wo, Wo, Wo, Wo, Wo, Wo, Gg, Re, Ch, Gg, Wo, Wo, Wo, Aa^Fpa, Aa^Fpa, Wo, Aa, Wo, Wo, Wo, Wo, Wo, Wo, Wo, Gll^Fp, Re, Re, Gg, Gg, Gg, Gg, Gll^Fp, Gll^Fp, Gll^Fp, Re, Re, Gg, Re, Re, Re, Re, Re, Gg, Re, Re, Re, Re, Ch, 6 Kh^Vov, Ch, Gg, Gg, Gg, Gg, Gg
Wo, Wo, Wo, Wo, Wo, Wo, Wo, Wo, Wo, Wo, Wo, Wo, Wo, Wo, Hh, Re, Gll^Fp, Gll^Fp, Gg, Gg, Wo, Wo, Wo, Wo, Wo, Gll^Fp, Gll^Fp, Re, Gg, Gg, Gg^Fp, Wo, Wo, Wo, Wo, Wo, Wo, Wo, Wo, Wo, Wo, Wo, Wo, Gll^Fp, Re, Gg, Wo, Wo, Aa, Wo, Aa^Fpa, Wo, Wo, Wo, Wo, Wo, Wo, Wo, Wo, Wo, Wo, Gg, Gs^Vh, Gll^Fp, Gll^Fp, Gg, Gg, Gg, Gg, Gll^Fp, Gll^Fp, Gll^Fp, Gg, Gs^Vh, Re, Gll^Fp, Gll^Fp, Gll^Fp, Gll^Fp, Gll^Fp, Gg, Gg, Gg, Gg, Gg, Ch, Re, Gg, Gg, Gg, Gg, Gg
Wo, Wo, Wo, Wo, Wo, Wo, Wo, Wo, Wo, Wo, Wo, Gg, Gll^Fp, Hh, Gg, Re, Gs^Vh, Gll^Fp, Gg, Gg, Wo, Wo, Wo, Wo, Wo, Wo, Gg, Re, Gll^Fp, Gg, Gg, Wo, Wo, Wo, Wo, Wo, Wo, Wo, Wo, Wo, Wo, Wo, Wo, Gg, Re, Gll^Fp, Wo, Aa, Gll^Fp, Wo, Wo, Wo, Wo, Wo, Wo, Wo, Wo, Wo, Wo, Wo, Wo, Wo, Re, Gll^Fp, Gll^Fp, Gg, Gg, Gg, Gll^Fp, Gg, Gg, Gll^Fp, Gg, Gg, Gll^Fp, Re, Gll^Fp, Gll^Fp, Gll^Fp, Gll^Fp, Gg, Gg, Gg, Gg, Gg, Gg, Gg, Re, Gg, Gll^Fp, Gg, Gg
Wo, Wo, Wo, Wo, Wo, Wo, Wo, Wo, Wo, Wo, Wo, Gg, Gg, Gg, Gg, Gg, Wo, Gg, Wo, Wo, Wo, Wo, Wo, Gg, Gll^Fp, Wo, Gg, Re, Gg, Gg, Gg, Wo, Wo, Wo, Wo, Wo, Wo, Wo, Wo, Wo, Wo, Wo, Wo, Gll^Fp, Re, Gg, Wo, Gll^Fp, Gg, Wo, Wo, Wo, Gg, Wo, Wo, Wo, Gg, Wo, Wo, Wo, Gg, Re, Gll^Fp, Gg, Gg, Gg, Gg, Gll^Fp, Gll^Fp, Gg, Re, Gg, Re, Gg, Re, Re, Gs^Vh, Gll^Fp, Gll^Fp, Gg, Gg, Gg, Gg, Gg, Gg, Gg, Gll^Fp, Re, Gll^Fp, Gll^Fp, Gg, Gg
Wo, Wo, Wo, Wo, Wo, Wo, Wo, Wo, Wo, Wo, Wo, Wo, Wo, Gg, Wo, Wo, Wo, Wo, Wo, Wo, Wo, Wo, Wo, Gg, Gll^Fp, Gll^Fp, Ch, Ch, Ch, Gg, Gll^Fp, Wo, Wo, Wo, Wo, Wo, Wo, Wo, Wo, Wo, Wo, Wo, Wo, Gg, Re, Gll^Fp, Gg, Wo, Gll^Fp, Wo, Gg, Wo, Wo, Wo, Gll^Fp, Gg, Re, Gg, Gll^Fp, Wo, Re, Re, Gg, Gg, Gg, Gg, Gg, Gg, Re, Re, Gg, Re, Gg, Re, Gg, Gg, Gg, Re, Re, Re, Re, Gg, Gg, Gll^Fp, Gg, Gg, Gg, Re, Gll^Fp, Gll^Fp, Gg, Gg
Wo, Wo, Wo, Wo, Wo, Wo, Wo, Wo, Wo, Wo, Wo, Wo, Wo, Wo, Wo, Wo, Wo, Wo, Wo, Wo, Wo, Wo, Gg, Gg, Gg, Gg, Ch, 2 Kh^Vov, Ch, Gll^Fp, Re, Gg, Wo, Wo, Wo, Wo, Wo, Wo, Re, Gg, Gg, Gg, Gg, Gg, Re, Gg, Gg, Gll^Fp, Gll^Fp, Gg, Gg, Gg, Gg, Gg, Re, Re, Gll^Fp, Re, Re, Ket^Vh, Gg, Gll^Fp, Gg, Gg, Gll^Fp, Gg, Gg, Gg, Re, Gg, Gll^Fp, Gll^Fp, Gll^Fp, Gll^Fp, Gg, Gg, Gg, Gg, Gg, Gg, Gg, Re, Re, Gg, Gg, Gll^Fp, Gg, Gg, Re, Gg, Gg, Gg
Wo, Wo, Wo, Wo, Wo, Wo, Wo, Wo, Wo, Wo, Wo, Wo, Wo, Wo, Wo, Wo, Wo, Wo, Wo, Wo, Wo, Wo, Gll^Fp, Gg, Re, Re, Gg, Ch, Gg, Re, Gg, Gs^Vh, Wo, Wo, Wo, Wo, Wo, Gg, Ch, Kh^Vov, Ch, Re, Re, Re, Gll^Fp, Re, Re, Gg, Gg, Gg, Gg, Gg, Re, Re, Gg, Gg, Gg, Gll^Fp, Gg, Gll^Fp, Gg, Gg, Gg, Gg, Gg, Gg, Re, Re, Gg, Gg, Gg, Gll^Fp, Gg, Gll^Fp, Gll^Fp, Gg, Gg, Gg, Gg, Gg, Re, Gll^Fp, Gg, Re, Re, Gg, Re, Re, Gg, Re, Re, Gg
Wo, Wo, Wo, Wo, Wo, Wo, Wo, Wo, Wo, Wo, Wo, Wo, Wo, Wo, Wo, Wo, Wo, Wo, Wo, Wo, Wo, Wo, Gg, Gg, Re, Gll^Fp, Gll^Fp, Gg, Gg, Gg^Fp, Gg, Gg, Wo, Wo, Wo, Wo, Gg, Gg, Re, Ch, Gg, Gg, Gll^Fp, Gg, Gg, Gg, Gg, Gs^Vh, Re, Re, Re, Gg, 8 Kh^Vov, Gg, Gg, Gg, Gg, Gg, Gg, Gg, Gg, Gg, Gg, Gg, Re, Re, 3 Kh^Vov, Gg, Gg, Gg, Gg, Gll^Fp, Gg, Gg, Gg, Gg, Re, Gg, Re, Re, Gg, Gg, Gll^Fp, Gll^Fp, Gg, Re, Gg, Gg, Gg, Gg, Gll^Fp, Re
Wo, Wo, Wo, Wo, Wo, Wo, Wo, Wo, Wo, Wo, Wo, Wo, Wo, Wo, Wo, Wo, Wo, Wo, Wo, Wo, Gg, Gg, Ket^Vh, Re, Gg, Gll^Fp, Gg, Gg^Fp, Gg, Gg, Gg, Ww, Ww, Wo, Gg, Wo, Wo, Wo, Wo^Bsb|, Wo, Wo, Wo, Wo, Gll^Fp, Gll^Fp, Gg, Gll^Fp, Gg, Gll^Fp, Gg, Gg, Ch, Ch, Ch, Re, Re, Re, Gg, Re, Gg, Gg, Gll^Fp, Re, Re, Gg, Ch, Ch, Ch, Mm, Gg, Gg, Gg, Gg, Gg, Re, Re, Gg, Re, Gll^Fp, Gll^Fp, Gg, Gg, Gg, Gg, Re, Gs^Vh, Gg, Gll^Fp, Gg, Gg, Gll^Fp, Gg
Wo, Wo, Wo, Wo, Wo, Wo, Wo, Wo, Wo, Wo, Wo, Wo, Wo, Wo, Wo, Wo, Wo, Wo, Wwt, Gg, Wo, Wo, Wo, Wo, Wo, Gg, Wo, Gg, Wo, Ww, Ww, Wwf, Gg, Gg, Gll^Fp, Gll^Fp, Gg, Gg, Gs^Vh, Gg, Gll^Fp, Gg, Gg, Wo, Gg, Gg, Gg, Gg, Gg, Gg, Gs^Vh, Re, Gg, Gg, Gg, Gg, Gg, Gll^Fp, Gg, Gll^Fp, Gg, Gs^Vh, Gg, Gg, Mm, Mm, Mm, Mm, Mm, Mm, Mm, Mm, Mm, Re, Gg, Gll^Fp, Gg, Gg, Gg, Gg, Gg, Gll^Fp, Gg, Re, Gg, Gg, Gll^Fp, Gll^Fp, Gg, Gg, Gg, Gg
Wo, Wo, Wo, Wo, Wo, Wo, Wo, Wo, Wo, Wo, Wo, Wo, Wo, Wo, Wo, Wo, Wo, Wwt, Wwt, Wo, Wo, Wo, Wo, Wo, Wo, Wo, Wo, Wo, Wo, Wo, Gg, Gg, Gg, Gll^Fp, Gll^Fp, Gg, Gll^Fp, Gg, Re, Gg, Gg, Gg, Gs^Wm, Wo, Wo, Gg, Re, Gs^Vh, Re, Re, Gg, Gg, Gg, Gg, Mm, Gg, Gg, Gg, Gg, Gg, Re, Gll^Fp, Gll^Fp, Mm, Mm, Mm, Mm, Mm, Mm, Mm, Mm, Gg, Re, Re, Mm, Gg, Gg, Gg, Gg, Gg, Gg, Gg, Gll^Fp, Re, Gg, Gll^Fp, Gll^Fp, Gg, Gg, Gg, Gg, Gg
Wo, Wo, Wo, Wo, Wo, Wo, Wo, Wo, Wo, Wo, Wo, Wo, Wo, Wo, Wo, Wo, Wo, Wwt, Wwt, Wo, Wo, Wo, Wo, Wo, Wo, Wo, Wo, Wo, Gg, Gll^Fp, Gg, Gg, Gg, Gg, Gg^Fp, Gg, Ch, Ch, Ch, Gll^Fp, Gg, Gg, Gg, Gg, Re, Wo^Bsb/, Gg, Gg, Gg, Re, Gll^Fp, Gg, Gll^Fp, Gg, Gll^Fp, Gll^Fp, Mm, Mm, Gll^Fp, Gg, Gg, Gll^Fp, Gg, Mm, Mm, Mm, Gg, Mm, Gg, Mm, Re, Re, Gg, Gg, Gg, Gg, Gg, Gll^Fp, Gg, Gg, Gg, Gll^Fp, Gg, Re, Gll^Fp, Gg, Gg, Gg, Gg, Gg, Gg, Gg
Wo, Wo, Wo, Wo, Wo, Wo, Wo, Wo, Wo, Wo, Wo, Wo, Wo, Wo, Wo, Wo, Wo, Wwt, Wwt, Wo, Gll^Fp, Ket^Vh, Gg, Wo, Wo, Gg, Gg, Gg, Gll^Fp, Gg, Re, Gs^Vh, Re, Gg, Gg, Gg, Ch, 4 Kh^Vov, Ch, Gg, Re, Gg, Re, Re, Gs^Vh, Wo, Gg, Gg, Mm, Gs^Vh, Mm, Gll^Fp, Gll^Fp, Gll^Fp, Wo, Mm, Mm, Mm, Ch, Gg, Gg, Gg, Gg, Gg, Gll^Fp, Gg, Gg, Gg, Re, Re, Gg, Gg, Hh^Fp, Hh^Fp, Hh, Mm, Mm, Gg, Gg, Gll^Fp, Gg, Gg, Gg, Re, Gg, Gg, Gll^Fp, Gg, Gg, Gll^Fp, Gg, Gg
Wo, Wo, Wo, Wo, Wo, Wo, Ch, Ch, Ch, Wo, Wo, Wo, Wo, Wo, Wo, Wo, Wo, Wwt, Wwt, Wwt, Wwt, Re, Re, Gg, Gg, Gg, Gll^Fp, Gll^Fp, Gg, Re, Gg, Gg, Gll^Fp, Re, Re, Re, Gg, Ch, Gg, Re, Gg, Re, Gg, Gg^Fp, Wo, Wo, Gg, Mm, Mm, Mm, Wo, Wo, Wo, Wo, Hh, Wo, Wo, Ch, Kh^Vov, Ch, Re, Re, Gs^Vh, Gll^Fp, Gll^Fp, Gll^Fp, Gg, Re, Gg, Gg, Mm, Hh, Hh, Hh^Fp, Hh, Mm, Mm, Mm, Gg, Gg, Gg, Gg, Gg, Gs^Vh, Gll^Fp, Gll^Fp, Gll^Fp, Gg, Gll^Fp, Gg, Gll^Fp, Gg
Wo, Wo, Wo, Wo, Wo, Ch, Rr^Vhc, Ch, Rr^Vhc, Ch, Ch, Wo, Wo, Wo, Wo, Wo, Wwt, Wwt, Wwt, Wwt, Wo, Wo, Wo, Re, Re, Gg, Gg, Gg, Gg, Re, Gg, Gll^Fp, Gg, Re, Gg, Gg^Fp, Gg, Re, Re, Gg, Hh^Fp, Hh^Fp, Hh, Gg, Wo, Gg, Wo, Mm, Mm, Wo, Mm, Mm, Mm, Hh, Hh, Hh, Wo, Ch, Ch, Ch, Gg, Gg, Gg, Re, Re, Gg, Re, Re, Gg, Mm, Mm, Mm, Hh^Fp, Hh^Fp, Hh^Fp, Hh, Hh, Mm, Mm, Gg, Gll^Fp, Gg, Re, Re, Re, Gll^Fp, Gll^Fp, Gg, Gg, Gg, Gg, Gg
Wo, Wo, Wo, Wo, Wo, Ch, Rr^Vhc, Ch, Rr^Vhc, Rr^Vhc, Rr^Vhc, Ch, Ch, Wo, Wwt, Wwt, Wwt, Wwt, Wo, Wo, Wo, Wo, Wo, Wo, Gll^Fp, Re, Re, Gg, Re, Re, Gg, Gll^Fp, Gg, Re, Gg, Gg, Gll^Fp, Gg, Gll^Fp, Re, Hh^Fp, Hh, Mm, Hh, Hh^Fp, Wo, Mm, Wo, Wo, Mm, Mm, Mm, Mm, Mm, Mm, Mm, Mm, Wo, Wo^Bsb|, Wo, Wo, Wo, Wo, Gg, Gg, Re, Kh^Vov, Gg, Gg, Gg, Hh, Hh^Fp, Hh, Hh, Hh, Hh^Fp, Hh, Mm, Mm, Gg, Gg, Re, Gll^Fp, Gg, Gg, Re, Re, Re, Re, Gg, Wo, Gg
Wo, Wo, Wo, Wo, Wo, Ch, Rr^Vhc, 1 Kh^Vov, Rr^Vhc, Rr^Vhc, Rr^Vhc, Rr^Vhc, Ch, Ch, Wwt, Wwt, Wo, Wo, Wo, Wo, Wo, Wo, Wo, Wo, Gg, Gll^Fp, Gg, Re, Gll^Fp, Gll^Fp, Gg, Gll^Fp, Gg, Re, Gg^Fp, Gll^Fp, Mm, Gg, Mm, Re, Gg, Hh, Mm, Hh, Mm, Mm, Mm, Mm, Mm, Gs^Wm, Mm, Mm, Mm, Mm, Mm, Mm, Mm, Gg, Re, Gg, Gg, Gll^Fp, Gll^Fp, Wo, Wo, Ch, Ch, Ch, Gg, Gg, Hh, Hh^Fp, Hh, Hh^Fp, Hh, Hh^Fp, Mm, Mm, Mm, Gg, Re, Re, Gg, Gg, Gg, Gg, Gg, Gg, Gg, Ket^Vh, Wo, Wo
Wo, Wo, Wo, Wo, Wo, Ch, Rr^Vhc, Ch, Rr^Vhc, Rr^Vhc, Ch, Ch, Wo, Wwt, Wo, Wo, Wo, Wo, Wo, Wo, Wo, Wo, Wo, Wo, Wo, Gg, Gg, Re, Gg, Gg, Re, Gg, Re, Re, Gg, Gll^Fp, Mm, Mm, Re, Re, Gg, Mm, Mm, Mm, Mm, Mm, Mm, Mm, Mm, Mm, Mm, Mm, Mm, Mm, Mm, Mm, Gg, Gg, Re, Re, Re, Gg, Gg, Gg, Wo^Bsb/, Re, Gg, Gg, Gg, Gg, Mm, Mm, Mm, Hh^Fp, Mm, Mm, Mm, Mm, Gg, Gg, Re, Gg, Wo, Wo, Wo, Wo, Wo, Wo, Wo, Gg, Wo, Wo
Wo, Wo, Wo, Wo, Wo, Ch, Ch, Ch, Ch, Ch, Wo, Wo, Wo, Wo, Wo, Wo, Wo, Wo, Wo, Wo, Wo, Wo, Wo, Wo, Gll^Fp, Gll^Fp, Gll^Fp, Re, Re, Re, Gll^Fp, Re, Gg, Re, Re, Gll^Fp, Gs^Vh, Re, Gll^Fp, Gll^Fp, Mm, Mm, Mm, Mm, Gs^Wm, Mm, Mm, Mm, Mm, Mm, Mm, Mm, Gs^Fds, Mm, Gg, Gg, Re, Re, Hh, Hh^Fds, Hh^Fds, Re, Re, Re, Gg, Wo, Gg, Gg, Gg, Gg, Mm, Mm, Mm, Mm, Mm, Mm, Gg, Gg, Gll^Fp, Gg, Re, Gg, Wo, Gg, Gg, Gg, Hh^Fp, Hh, Hh, Wo, Wo, Wo
Wo, Wo, Wo, Wo, Wo, Wo, Wwt, Ch, Wwt, Wo, Wo, Wo, Wo, Wo, Wo, Wo, Wo, Wo, Wo, Wo, Wo, Wo, Wo, Wo, Gg, Gg, Gg, Re, Gg, Gll^Fp, Mm, Gll^Fp, Mm, Gll^Fp, Gll^Fp, Re, Re, Gg, Gll^Fp, Mm, Mm, Mm, Mm, Mm, Mm, Mm, Mm, Mm, Gs^Fds, Mm, Gg, Gs^Fds, Re, Gg, Re, Re, Gg, Gg, Gg, Hh, Hh^Fds, Hh, Gs^Vh, Gg, Gg, Wo, Wo, Gg, Mm, Mm, Mm, Mm, Mm, Mm, Gg, Gg, Gg, Gll^Fp, Re, Re, Gg, Gg, Wo, Re, Gg, Gg^Fp, Hh^Fp, Hh^Fp, Wo, Wo, Wo, Wo
Wo, Wo, Wo, Wo, Wo, Wo, Wwt, Wwt, Wwt, Wo, Gg, Wo, Wo, Wo, Wo, Wo, Wo, Wo, Wo, Wo, Wo, Wo, Wo, Wo, Gg, Gll^Fp, Gg, Re, Gg, Gll^Fp, Mm, Mm, Mm, Mm, Mm, Gg, Gg, Re, Gg, Mm, Mm, Mm, Mm, Mm, Mm, Mm, Gs^Fds, Gg, Gg, Gg, Re, Ket^Vh, Wo, Re, Gg, Mm, Mm, Gg, Gg, Hh^Fds, Hh, Hh, Re, Gg, Gg^Fds, Gg, Gg, Wo, Wo, Mm, Gll^Fp, Gg, Gg^Fp, Gg^Fp, Re, Re, Re, Gg, Kh^Vov, Gg, Gg, Gg, Re^Bsb/, Re, Re, Gg, Gg, Hh, Wo, Wo, Wo, Wo
Wo, Wo, Wo, Wo, Wo, Wo, Wo, Gg, Gg, Hh^Fp, Gg, Gll^Fp, Gg, Wo, Gg, Wo, Wo, Wo, Wo, Wo, Wo, Wo, Wo, Wo, Gll^Fp, Gg, Re, Gs^Vh, Re, Gg, Mm, Mm, Mm, Mm, Mm, Mm, Re, Re, Gll^Fp, Mm, Mm, Mm, Mm, Mm, Re, Gg, Gg, Gg, Gs^Vh, Gg, Re, Wo, Wo, Wo, Wo, Mm, Mm, Mm, Mm, Hh, Gg, Gg, Hh^Fds, Re, Mm, Mm, Gg^Fds, Gg, Wo, Gg, Re, Re, Gs^Vh, Re, Gg, Gg, Gll^Fp, Ch, Ch, Ch, Re, Re, Gg, Wo, Re, Gg^Fp, Gg^Fp, Wo, Wo, Wo, Wo, Wo
Wo, Wo, Wo, Wo, Wo, Wo, Wo, Gg, Gg, Gg, Re, Re, Re, Re, Re, Gg, Ket^Vh, Wo, Wo, Wo, Wo, Wo, Wo, Gg, Gg, Re, Gll^Fp, Gg, Re, Gg, Mm, Mm, Mm, Mm, Mm, Gll^Fp, Re, Gg, Gll^Fp, Mm, Re, Mm, Re, Re, Mm, Re, Re, Re, Gs^Fds, Re, Gg, Wo, Wo, Wo, Wo, Gg^Fds, Wo, Mm, Mm, Mm, Mm, Hh^Fds, Hh, Re, Re, Mm, Gg^Fds, Gg, Gg, Wo, Wo^Bsb|, Wo, Wo, Gg, Gll^Fp, Gll^Fp, Hh^Fp, Gll^Fp, Hh^Fp, Gll^Fp, Hh^Fp, Gll^Fp, Wo, Wo, Re, Gg, Gg, Wo, Wo, Wo, Wo, Wo
Wo, Wo, Wo, Wo, Wo, Wo, Wo, Gg, Gll^Fp, Gg, Re, Gg, Hh^Fp, Gg, Hh^Fp, Re, Re, Gg, Gg, Mm, Mm, Wo, Mm, Gll^Fp, Re, Re, Gll^Fp, Gll^Fp, Re, Gg^Fp, Gg, Mm, Re, Re, Re, Gg, Re, Gg, Re, Re, Mm, Re, Mm, Mm, Wo, Ket^Vh, Mm, Mm, Mm, Re, Gg, Gs^Fds, Wo, Wo, Wo, Wo, Wo, Gs^Fds, Gg^Fds, Mm, Mm, Mm, Mm, Mm, Mm, Re, Re, Gg^Fds, Gg, Gg, Re, Gg, Mm, Wo, Wo, Wo, Wo, Hh^Fp, Wo, Hh^Fp, Wo, Hh^Fp, Wo, Gg^Fp, Gg, Re, Gg, Wo, Wo, Wo, Wo, Wo
Wo, Wo, Wo, Wo, Wo, Wo, Gs^Vh, Gg, Gg, Gg, Re, Hh, Gll^Fp, Hh, Hh^Fp, Hh, Mm, Re, Re, Mm, Mm, Mm, Mm, Gg, Re, Gg, Mm, Gg, Gg, Re, Re, Re, Gg, Gg, Wo, Re, Re, Re, Mm, Mm, Mm, Mm, Wo, Wo, Wo, Wo, Wo, Mm, Mm, Re, Re, Gg, Gs^Fds, Wo, Wo, Wo, Wo, Wo, Wo, Wo, Gg^Fds, Mm, Mm, Mm, Mm, Mm, Mm, Re, Re, Mm, Re, Mm, Re, Mm, Gg^Fds, Gg^Fds, Mm, Wo, Mm, Wo, Mm, Wo, Gg, Gg^Fp, Re, Re, Gg, Wo, Wo, Wo, Wo, Wo
Wo, Wo, Wo, Wo, Wo, Wo, Re, Re, Re, Re, Gg, Re, Re, Gg, Hh, Mm, Mm, Gg, Gg, Re, Re, Mm, Re, Re, Mm, Mm, Mm, Mm, Mm, Gg, Re, Re, Re, Wo, Wo, Wo, Wo, Ket^Vh, Gg, Mm, Wo, Wo, Wo, Wo, Wo, Wo, Wo, Wo, Gg, Mm, Re, Mm, Ch, Gs^Fds, Mm, Wo, Wo, Wo, Wo, Wo, Wo, Wo, Wo, Mm, Mm, Mm, Mm, Mm, Gg, Re, Mm, Re, Mm, Re, Re, Mm, Mm, Mm, Mm, Mm, Mm, Mm, Gg, Gg, Re, Gg, Gll^Fms, Gg, Wo, Wo, Wo, Wo
Wo, Wo, Wo, Wo, Wo, Gg, Re, Gll^Fp, Gg, Gg, Gll^Fp, Gg, Re, Gg, Ch, Mm, Gg, Gg, Hh, Gg, Gg, Re, Gg, Mm, Mm, Mm, Re, Re, Re, Mm, Re, Mm, Mm, Wo, Wo, Wo, Wo, Wo, Wo, Wo, Wo, Wo, Wo, Wo, Gg, Wo, Ww, Ww, Gg, Gg, Gg, Ch, 5 Kh^Vov, Ch, Mm, Wo, Wo, Wo, Wo, Wo, Wo, Wo, Wo, Wo, Wo, Mm, Gg, Mm, Gg^Fds, Re, Mm, Mm, Mm, Mm, Re, Gs^Vh, Mm, Mm, Mm, Mm, Mm, Mm, Gll^Fms, Gll^Fms, Re, Gg, Gll^Fms, Gll^Fms, Gg, Wo, Wo, Wo
Wo, Wo, Wo, Wo, Wo, Gg, Re, Gg, Gg, Gll^Fp, Gg, Gll^Fp, Gg, Ch, 7 Kh^Vov, Ch, Gg, Gg, Gg, Gll^Fp, Gg, Re, Gll^Fp, Gg, Re, Re, Mm, Mm, Mm, Re, Mm, Mm, Wo, Wo, Wo, Wo, Wo, Wo, Wo, Wo, Wo, Wo, Wo, Wo, Mm, Hh^Fds, Wwf, Wwf, Ww, Gg, Hh^Fds, Ch, Ch, Ch, Gg, Gs^Fds, Gs^Fds, Wo, Wo, Wo, Wo, Wo, Wo, Wo, Wo, Wo, Wo, Mm, Gg^Fds, Re, Mm, Mm, Mm, Mm, Re, Mm, Mm, Mm, Mm, Mm, Mm, Mm, Gg, Gll^Fms, Re, Gll^Fms, Gll^Fms, Gll^Fms, Gll^Fms, Wo, Gs, Gs
Wo, Wo, Wo, Wo, Gll^Fp, Gg, Re, Gg, Hh, Gll^Fp, Gll^Fp, Gg, Re, Ch, Ch, Ch, Re, Gg, Re, Gg, Re, Re, Re, Re, Gg, Gg, Wo, Wo, Wo, Wo, Wo, Wo, Wo, Wo, Wo, Wo, Wo, Wo, Wo, Wo, Wo, Wo, Wo, Gg, Hh, Hh^Fds, Ww, Gg, Wo, Wo, Wo, Hh^Fds, Hh^Fds, Re, Gg, Gg, Gs^Fds, Gg, Mm, Mm, Wo, Wo, Wo, Wo, Wo, Wo, Wo, Gg, Gs^Vh, Re, Re, Mm, Mm, Mm, Re, Mm, Re, Mm, Re, Mm, Re, Mm, Gg, Gg, Ch, Ch, Ch, Gll^Fms, Wo, Wo, Wo, Gs
Wo, Wo, Wo, Wo, Gg, Gg, Re, Gg, Gg, Gg, Gg, Re, Mm, Re, Re, Re, Gg, Re, Gg, Re, Gg, Gg, Gg, Ket^Vh, Wo, Wo, Wo, Wo, Wo, Wo, Wo, Wo, Wo, Wo, Wo, Wo, Wo, Wo, Wo, Wo, Wo, Wo, Wo, Mm, Gg, Gs^Vh, Wo, Wo, Wo, Wo, Wo, Gg, Gg, Mm, Mm, Re, Re, Gg, Gg, Gs^Fds, Gs^Vh, Wo, Wo, Wo, Wo, Wo, Wo, Gg^Fds, Re, Re, Mm, Re, Re, Re, Mm, Re, Mm, Re, Gg^Fds, Re, Gg, Re, Re, Re, Ch, Kh^Vov, Ch, Wo, Wo, Wo, Gs^Fms, Gs
Wo, Wo, Wo, Wo, Gll^Fp, Gg, Re, Gll^Fp, Gg, Gg, Re, Re, Hh, Gg, Re, Gg, Mm, Gg, Mm, Mm, Gg, Gg, Wo, Wo, Wo, Wo, Wo, Wo, Wo, Wo, Wo, Wo, Wo, Wo, Wo, Wo, Wo, Wo, Wo, Wo, Wo, Wo, Wo, Hh^Fds, Wwf, Ww, Wo, Wo, Wo, Wo, Wo, Wo, Wo, Gg, Mm, Gg, Hh^Fds, Re, Re, Re, Gg, Gg, Gg, Wo, Wo, Wo, Wo, Gg, Re, Mm, Mm, Mm, Mm, Re, Re, Mm, Gg, Hh, Wo, Wo, Wo, Gg^Fds, Wo, Wo, Wo, Ch, Wwf, Wo, Gs, Gs, Gs, Gs
Wo, Wo, Wo, Wo, Gg, Gg, Re, Re, Re, Gll^Fp, Gg, Gg, Gg, Hh, Re, Re, Re, Mm, Gll^Fp, Hh, Gg, Gll^Fp, Wo, Wo, Wo, Wo, Wo, Wo, Gs^Ft, Wo, Wo, Gs^Ft, Gs^Ft, Wo, Wo, Wo, Wo, Wo, Wo, Wo, Wo, Wo, Wo, Ww, Hh, Ww, Wo, Wo, Wo, Wo, Wo, Wo, Wo, Wo, Wo, Hh^Fds, Hh, Mm, Re, Mm, Gg, Wo, Wo, Gg, Gg, Wo, Wo, Wo, Mm, Re, Hh, Hh, Mm, Gg, Gg^Fds, Ket^Vh, Wo, Wo, Wo, Wo, Wo, Wo, Hh^Fds, Wo, Wo, Wo, Gs, Re, Gs^Vh, Gs, Re, Gs
Wo, Wo, Wo, Wo, Ket^Vh, Re, Gg, Gg, Re, Hh^Fp, Gg, Gg, Re, Re, Gg, Mm, Mm, Re, Re, Gg, Hh^Fp, Hh, Wo, Wo, Wo, Wo, Wo, Wo, Wo, Gs^Vc, Wo, Wo, Wo, Wo, Wo, Wo, Wo, Wo, Wo, Wo, Wo, Gg, Hh^Fds, Mm, Hh^Fds, Gg, Wo, Wo, Wo, Wo, Wo, Wo, Wo, Wo, Wo, Wo, Wo, Mm, Gg, Re, Gg, Wo, Wo, Wo, Gg, Wo, Wo, Mm, Mm, Re, Hh, Mm, Gg, Gg, Wo, Gg, Wo, Wo, Wo, Wo, Hh^Fds, Wo, Wo, Wo, Wo, Wo, Gs, Gs, Gs, Re, Gs, Re
Wo, Wo, Wo, Wo, Wo, Gg, Wo, Gll^Fp, Re, Gg, Re, Re, Mm, Mm, Mm, Gg, Gg, Mm, Gg, Re, Ket^Vh, Gg, Wo, Wo, Wo, Gs^Ft, Wo, Wo, Wo, Wo, Wo, Wo, Wo, Wo, Wo, Wo, Wo, Wo, Wo, Wo, Wo, Gg, Mm, Hh, Gs^Vh, Hh^Fds, Wo, Wo, Wo, Wo, Wo, Wo, Wo, Wo, Wo, Wo, Wo, Wo, Wo, Re, Gs^Vh, Wo, Wo, Wo, Wo, Wo, Wo, Wo, Mm, Re, Re, Mm, Mm, Gg, Wo, Wo, Wo, Wo, Wo, Wo, Wo, Wo, Wo, Wo, Hh, Wo, Wo, Gs^Fms, Gs, Gs^Fms, Gs, Gs
Wo, Wo, Wo, Wo, Wo, Wo, Wo, Wo, Wo, Re, Gg, Gg, Gg, Mm, Wo, Mm, Gg, Mm, Gg, Gg, Wo, Wo, Wo, Wo, Wo, Wo, Wo, Wo, Wo, Wo, Wo, Wo, Wo, Wo, Wo, Wo, Wo, Wo, Wo, Wo, Wo, Mm, Hh^Fds, Mm, Gg, Wo, Wo, Wo, Wo, Wo, Wo, Wo, Wo, Wo, Wo, Wo, Wo, Wo, Wo, Gs^Fds, Gs^Fds, Gg, Wo, Wo, Wo, Wo, Wo, Wo, Wo, Mm, Mm, Re, Re, Mm, Hh, Wo, Wo, Hh, Hh^Fds, Wo, Wo, Wo, Wo, Wo, Wo, Wo, Wo, Gs, Gs^Fms, Gs, Gs, Gs
Wo, Wo, Wo, Wo, Wo, Wo, Wo, Wo, Wo, Re, Wo, Wo, Wo, Wo, Wo, Wo, Wo, Gg, Gg, Wo, Wo, Wo, Wo, Wo, Wo, Wo, Wo, Wo, Wo, Wo, Wo, Wo, Wo, Wo, Wo, Wo, Wo, Wo, Wo, Gg, Wo, Wo, Mm, Hh, Hh^Fds, Wo, Wo, Wo, Wo, Wo, Wo, Wo, Wo, Wo, Wo, Wo, Wo, Wo, Mm, Mm, Wo, Wo, Wo, Wo, Wo, Wo, Wo, Wo, Wo, Wo, Hh, Mm, Re, Gg, Gg, Gg, Gg, Wo, Wo, Wo, Hh^Fds, Hh, Wo, Wo, Wo, Wo, Hh, Wo, Wo, Wo, Gs, Gs
Wo, Wo, Wo, Wo, Wo, Wo, Wo, Wo, Wo, Gs^Vh, Wo, Wo, Wo, Wo, Wo, Wo, Wo, Wo, Wo, Wo, Wo, Wo, Wo, Wo, Wo, Wo, Wo, Wo, Wo, Wo, Wo, Wo, Wo, Wo, Wo, Wo, Wo, Wo, Wo, Wo, Wo, Wo, Hh^Fds, Mm, Wo, Wo, Wo, Wo, Wo, Wo, Gg, Mm, Mm, Wo, Mm, Mm, Ww, Mm, Wo, Wo, Wo, Wo, Wo, Wo, Wo, Wo, Wo, Wo, Wo, Gs^Fds, Gg, Hh, Mm, Re, Ch, Kh^Vov, Ch, Wo, Wo, Wo, Wo, Wo, Wo, Wo, Wo, Wo, Wo, Wo, Hh^Fds, Wo, Wo, Gs
Wo, Wo, Wo, Wo, Wo, Wo, Wo, Wo, Wo, Wo, Wo, Wo, Wo, Wo, Wo, Wo, Wo, Wo, Wo, Wo, Wo, Wo, Wo, Wo, Wo, Wo, Wo, Wo, Wo, Wo, Wo, Wo, Wo, Wo, Wo, Wo, Wo, Wo, Wo, Wo, Wo, Wo, Wo, Wo, Wo, Wo, Wo, Wo, Wo, Wo, Wo, Gg, Gg, Hh, Hh^Fds, Mm, Wo, Wo, Wo, Wo, Wo, Wo, Wo, Wo, Wo, Wo, Wo, Wo, Wo, Wo, Gs^Fds, Mm, Mm, Mm, Mm, Ch, Wo, Wo, Wo, Hh^Fds, Wo, Wo, Wo, Gs^Vh, Hh^Fds, Wo, Wo, Wo, Wo, Wo, Wo, Gs
Wo, Wo, Wo, Wo, Wo, Wo, Wo, Wo, Gs, Gs, Gs, Wo, Wo, Wo, Wo, Wo, Wo, Wo, Wo, Wo, Wo, Wo, Wo, Wo, Wo, Wo, Wo, Wo, Wo, Wo, Wo, Wo, Wo, Wo, Wo, Wo, Wo, Wo, Wo, Wo, Wo, Wo, Wo, Wo, Wo, Wo, Wo, Wo, Wo, Wo, Wo, Wo, Wo, Gs^Vh, Gg, Gg, Wo, Wo, Wo, Wo, Wo, Wo, Wo, Wo, Wo, Wo, Wo, Wo, Wo, Wo, Wo, Gs^Fds, Gs^Fds, Mm, Gs^Fds, Mm, Wo, Wo, Wo, Wo, Wo, Wo, Wo, Hh^Fds, Wo, Wo, Wo, Wo, Hh, Wo, Wo, Wo
Wo, Wo, Wo, Wo, Wo, Wo, Gs^Ft, Gs, Rd, Dd^Vda, Rd, Gs, Gs, Gs, Wo, Wo, Wo, Wo, Wo, Wo, Wo, Wo, Wo, Wo, Dd, Wo, Dd, Wo, Gs, Wo, Gs, Wo, Wo, Wo, Wo, Wo, Wo, Wo, Gs, Wo, Gs, Wo, Gs^Ft, Wo, Wo, Wo, Wo, Wo, Wo, Wo, Wo, Wo, Wo, Wo, Wo, Gg, Wo, Wo, Wo, Wo, Wo, Wo, Wo, Wo, Wo, Wo, Wo, Wo, Wo, Wo, Wo, Wo, Wo, Gg, Gg, Wo, Wo, Hh, Wo, Wo, Hh, Hh, Wo, Wo, Wo, Wo, Wo, Wo, Wo, Wo, Wo, Wo
Wo, Wo, Gs^Ft, Wo, Gs, Gs^Ft, Rd, Rd, Dd, Dd, Dd, Rd, Rd, Gs, Gs, Wo, Wo, Wo, Wo, Wo, Gs, Wo, Gs, Gs^Ft, Gs^Ft, Dd, Rd, Gs, Rd, Gs, Rd, Gs, Gs, Gs^Ft, Gs^Ft, Gs^Ft, Gs, Gs, Rd, Gs, Dd, Gs, Gs^Ft, Gs^Ft, Gs^Ft, Gs, Wo, Wo, Wo, Wo, Wo, Wo, Wo, Wo, Wo, Wo, Wo, Wo, Wo, Wo, Wo, Wo, Wo, Wo, Wo, Wo, Wo, Wo, Wo, Wo, Wo, Wo, Wo, Wo, Wo, Wo, Wo, Wo, Wo, Wo, Wo, Wo, Wo, Wo, Wo, Wo, Gg, Hh^Fds, Wo, Wo, Wo, Wo
Wo, Gs^Ft, Gs^Ft, Gs, Rd, Rd, Dd, Dd, Dd, Dd, Dd, Dd, Dd, Rd, Rd, Gs, Rd, Dd, Rd, Dd, Rd, Gs^Ft, Rd, Dd^Vda, Rd, Rd, Dd, Rd, Dd, Rd, Dd, Rd, Rd, Rd, Rd, Rd, Rd, Rd, Dd, Dd^Vda, Rd, Dd, Gs^Ft, Gs^Ft, Gs^Ft, Wo, Wo, Wo, Wo, Wo, Wo, Wo, Wo, Wo, Wo, Wo, Wo, Wo, Wo, Wo, Wo, Wo, Wo, Wo, Wo, Wo, Wo, Wo, Wo, Wo, Wo, Wo, Wo, Wo, Wo, Wo, Mm, Wo, Mm, Wo, Gs^Vh, Wo, Mm, Mm, Mm, Wo, Wo, Wo, Wo, Wo, Wo, Wo
Wo, Wo, Dd, Dd, Rd, Dd, Dd, Dd, Md, Md, Md, Dd, Dd, Dd, Dd, Rd, Dd, Rd, Dd, Rd, Dd, Rd, Dd, Dd, Dd, Dd, Dd, Dd, Dd, Dd, Dd, Dd, Dd, Dd, Dd, Dd, Dd, Dd, Dd, Dd, Dd, Rd, Rd, Gs, Gs, Wo, Wo, Wo, Wo, Wo, Wo, Wo, Wo, Wo, Wo, Wo, Wo, Wo, Wo, Wo, Wo, Wo, Wo, Wo, Wo, Wo, Wo, Wo, Wo, Wo, Wo, Wo, Wo, Wo, Wo, Wo, Wo, Mm, Wo, Mm, Wo, Mm, Wo, Wo, Wo, Wo, Wo, Wo, Wo, Wo, Wo, Wo
Wo, Wo, Wo, Rd, Dd, Dd, Md, Md, Md, Md, Md, Dd, Qxu, Dd, Qxu, Dd, Qxu, Dd, Dd, Dd, Qxu, Dd, Dd, Dd, Dd, Dd, Dd, Dd, Dd, Dd, Dd, Dd, Dd, Dd, Dd, Dd, Dd, Dd, Dd, Dd, Dd, Rd, Dd, Gs, Gs, Wo, Wo, Wo, Wo, Wo, Wo, Wo, Wo, Wo, Wo, Wo, Wo, Wo, Wo, Wo, Wo, Wo, Wo, Wo, Wo, Wo, Wo, Wo, Wo, Wo, Wo, Wo, Wo, Wo, Wo, Wo, Wo, Wo, Wo, Wo, Wo, Wo, Wo, Wo, Wo, Wo, Wo, Wo, Wo, Wo, Wo, Wo
