Hh, Hh, Hh, Hh, Hh, Hh, Hh, Hh, Hh, Hh, Rr, Hh, Hh, Hh, Hh, Hh, Hh, Hh, Hh, Hh, Hh, Hh, Hh, Hh, Hh, Hh, Hh, Hh, Hh, Hh, Hh, Hh, Hh, Hh, Hh, Hh, Hh, Hh, Hh, Hh, Hh, Hh, Hh, Hh, Hh, Hh, Hh, Hh, Hh, Hh, Hh, Hh, Hh, Hh, Hh, Hh, Gg, Gg, Wo, Gg, Gg, Gg
Hh, Hh, Hh, Hh, Hh, Hh, Hh, Hh, Hh, Hh, Rr, Hh, Hh, Hh, Hh, Hh, Hh, Hh, Hh^Vhh, Hh, Hh, Hh, Hh, Hh, Hh, Hh^Vhh, Hh, Hh, Hh, Hh, Hh^Vhh, Hh, Hh, Hh, Hh, Hh^Vhh, Hh, Hh, Mm, Hh, Mm, Hh, Mm, Hh, Mm, Hh, Mm, Hh, Mm, Mm, Mm, Hh, Mm, Hh, Hh, Hh, Gg, Gg, Wo, Gg, Gg, Gg
Hh, Hh, Hh, Hh^Vhh, Hh, Hh, Hh, Hh, Hh, Hh, Rr, Hh^Vhh, Hh, Hh, Hh, Hh, Hh, Hh, Hh, Hh, Hh, Hh^Vhh, Hh, Hh, Hh, Hh, Hh, Hh, Hh, Hh, Mm, Hh, Mm, Hh, Mm, Mm, Mm, Mm, Mm, Mm, Mm, Mm, Mm, Mm, Ms, Mm, Ms, Mm, Mm, Mm, Mm, Mm, Mm, Hh, Hh, Hh, Gg, Gg, Wo, Gg, Gg, Gg
Hh, Hh, Hh, Hh, Hh, Hh, Hh, Hh, Hh, Hh, Rr, Hh, Hh, Hh, Hh, Hh, Hh, Hh, Hh, Hh, Hh, Hh, Hh, Hh, Mm, Mm, Mm, Mm, Mm, Mm, Mm, Mm, Mm, Mm, Ms, Mm, Ms, Ms, Ms, Ms, Ms, Ms, Ms, Ms, Aa, Ms, Aa, Ms, Ms, Ms, Ms, Mm, Mm, Mm, Hh, Hh, Gg, Gg, Wo, Gg, Gg, Gg
Hh, Hh, Hh, Hh, Hh, Hh, Hh, Hh^Vhh, Hh, Hh, Rr, Hh, Hh^Vhh, Hh^Vhh, Hh, Hh, Hh, Hh, Hh, Hh, Mm, Hh, Mm, Mm, Mm, Mm, Mm, Mm, Ms, Mm, Ms, Ms, Ms, Ms, Aa, Ms, Aa, Aa, Aa, Aa, Aa, Aa, Aa, Aa, Aa, Aa, Aa, Aa, Aa, Ms, Ms, Mm, Mm, Mm, Hh, Hh, Gg, Wo, Gg, Gg, Rr, Rr
Hh, Hh, Hh, Hh, Hh, Hh, Hh, Hh, Hh, Hh, Rr, Hh, Hh, Hh, Hh, Hh, Hh, Hh, Mm, Mm, Mm, Mm, Mm, Mm, Ms, Ms, Ms, Ms, Aa, Ms, Aa, Aa, Aa, Aa, Aa, Aa, Aa, Aa, Ha, Ha, Ha, Ha, Ha, Ha, Ha, Aa, Aa, Aa, Aa, Aa, Ms, Mm, Mm, Hh^Vhh, Hh, Gg, Rr^Vhc, Wo, Rr^Vhc, Rr, Gg, Wo
Hh, Hh, Hh, Hh, Hh, Hh^Vhh, Hh, Hh, Hh, Hh, Rr, Hh, Hh, Hh, Hh, Hh, Mm, Mm, Mm, Mm, Ms, Ms, Ms, Ms, Aa, Aa, Aa, Aa, Aa, Aa, Aa, Aa, Aa, Aa, Aa, Aa, Aa, Ha, Aa, Ha, Aa, Aa, Aa, Aa, Aa, Aa, Aa, Aa, Aa, Aa, Ms, Mm, Mm, Hh, Hh, Gg, Rr^Vhc, Wo, Gg^Ve, Rr^Vhc, Wo, Wo
Hh, Hh, Hh, Hh, Hh, Hh, Hh, Hh, Hh, Hh, Rr, Rr, Hh, Hh, Mm, Mm, Mm, Mm, Mm, Mm, Ms, Ms, Aa, Aa, Aa, Aa, Aa, Aa, Aa, Aa, Aa, Aa, Ms^Xm, Ms^Xm, Ms^Xm, Aa, Aa, Aa, Aa, Aa, Ha, Ha, Ha, Aa, Aa, Aa, Aa, Aa, Aa, Aa, Ms, Mm, Hh, Hh, Gg, Rr^Vhc, Rr^Vhc, Wo^Bsb/, Rr^Vhc, Rr^Vhc, Wo, Wo
Hh, Hh, Hh, Hh^Vhh, Hh, Hh, Hh, Hh, Hh, Hh, Rr, Rr, Hh, Hh, Mm, Mm, Mm, Mm, Ms, Ms, Aa, Aa, Aa, Aa, Aa, Ha, Ha, Aa, Aa, Aa, Aa, Aa, Ms^Xm, Ms^Xm, Ms^Xm, Aa, Aa, Aa, Aa, Ha, Ha, Ha, Aa, Aa, Aa, Aa, Aa, Aa, Ms, Ms, Mm, Mm, Hh, Hh, Rr, Rr^Vhc, Rr^Vhc, Wo, Rr^Vhc, Wo, Wo, Wo
Hh, Hh, Hh, Hh, Hh, Hh, Hh, Hh, Hh, Hh, Hh, Rr, Mm, Mm, Mm, Mm, Mm, Mm, Ms, Aa, Aa, Aa, Ha, Aa, Ha, Ha, Ha, Aa, Aa, Ha, Aa, Aa, Aa, Aa, Aa, Aa, Aa, Aa, Aa, Aa, Aa, Aa, Aa, Aa, Aa, Aa, Ms, Ms, Ms, Ms, Mm, Hh, Rr, Rr, Gg, Gg, Rr^Vhc, Wo^Bsb/, Wo, Wo, Wo, Wo
Hh, Hh, Hh, Hh, Hh, Hh, Hh, Hh, Hh, Hh, Hh, Rr, Rr, Mm, Mm, Mm, Mm, Mm, Ms, Ms, Aa, Aa, Aa, Ha, Ha, Ha, Aa, Ha, Aa, Ha, Ha, Aa, Aa, Aa, Aa, Aa, Ha, Ha, Aa, Aa, Aa, Aa, Ms, Ms, Ms, Ms, Mm, Ms, Mm, Mm, Rr, Rr, Gg, Gg, Gg, Gg, Wo, Wo, Wo, Wo, Wo, Wo
Gg, Gg, Gg, Gg, Gg, Hh, Hh, Hh, Hh, Hh, Hh, Hh, Rr, Mm, Hh, Mm, Mm, Mm, Ms, Ms, Ms, Aa, Aa, Aa, Aa, Aa, Aa, Aa, Aa, Aa, Aa, Aa, Aa, Aa, Aa, Ha, Aa, Aa, Aa, Aa, Aa, Ms, Ms, Ms, Mm, Mm, Gg, Mm, Rr, Rr, Gg, Gg, Wo, Wo, Wo, Wo, Wo, Wo, Wo, Wo, Wo, Wo
Gg, Gg, Gg, Gg, Gg, Gg, Gg, Hh, Hh, Hh, Hh, Hh, Hh, Rr, Hh, Mm, Mm, Mm, Mm, Ms, Ms, Ms, Ms, Aa, Aa, Aa, Aa, Aa, Aa, Aa, Aa, Aa, Aa, Aa, Aa, Aa, Aa, Aa, Ms, Ms, Ms, Ms, Mm, Mm, Gg, Gg, Rr, Rr, Wo, Wo, Wo, Wo, Wo, Wo, Wo, Wo, Wo, Wo, Wo, Wo, Wo, Wo
Gg, Gg, Gg, Gg, Gg, Gg, Gg, Gg, Gg, Hh, Hh, Hh, Hh, Rr, Rr, Hh, Mm, Mm, Mm, Mm, Mm, Mm, Mm, Ms, Ms, Ms, Ms, Ms, Ms, Ms, Ms, Ms, Ms, Aa, Ms, Aa, Ms, Ms, Mm, Ms, Mm, Mm, Mm, Mm, Rr, Rr, Gg, Gg, Wo, Wo, Wo, Wo, Wo, Wo, Wo, Wo, Wo, Wo, Wo, Wo, Wo, Wo
Gg, Gg, Gg, Gg, Gg, Gg, Ch, Gg, Gg, Gg, Gg, Hh, Hh, Hh, Rr, Hh, Mm, Mm, Mm, Mm, Mm, Mm, Mm, Mm, Mm, Mm, Mm, Mm, Mm, Mm, Mm, Mm, Mm, Ms, Mm, Ms, Mm, Mm, Mm, Mm, Mm, Mm, Rr, Rr, Gg, Gg, Wo, Wo, Wo, Wo, Wo, Wo, Wo, Wo, Wo, Wo, Wo, Wo, Wo, Wo, Wo, Wo
Gg, Gg, Gg, Gg, Gg, Ch, 4 Kh, Ch, Gg, Gg, Gg, Gg, Gg, Hh, Rr, Hh, Hh, Mm, Mm, Mm, Mm, Mm, Mm, Mm, Mm, Mm, Mm, Mm, Mm, Mm, Mm, Mm, Mm, Mm, Mm, Mm, Mm, Mm, Gg, Gg, Rr, Rr, Gg, Gg, Wo, Wo, Wo, Wo, Wo, Wo, Wo, Wo, Wo, Wo, Wo, Wo, Wo, Wo, Wo, Wo, Wo, Wo
Gs^Vh, Gs^Vh, Gs^Vh, Gg, Gg, Ch, Ch, Ch, Gg, Gg, Gg, Gg, Gg, Rr, Rr, Hh, Hh, Hh, Hh, Mm, Hh, Mm, Mm, Mm, Mm, Mm, Mm, Mm, Hh, Hh, Hh, Mm, Mm, Mm, Hh, Hh, Hh, Gg, Rr, Rr, Ds, Gg, Ds, Wog, Wog, Wog, Wog, Wog, Wog, Wog, Wog, Wog, Wog, Wog, Wog, Wog, Wog, Wog, Wog, Wog, Wog, Wog
Gs^Vh, Gs^Vh, Gs^Vh, Gg, Gg, Gg, Gg, Gg, Gg, Gg, Gg, Gg, Rr, Rr, Hh, Hh, Hh, Hh, Mm, Mm, Mm, Mm, Mm, Mm, Mm, Mm, Mm, Mm, Mm, Hh, Mm, Mm, Mm, Mm, Hh, Hh^Vhh, Rr, Rr, Ds, Ds, Ds, Ds, Wog, Wog, Wog, Wog, Wog, Wog, Wog, Wog, Wog, Wog, Wog, Wog, Wog, Wog, Wog, Wog, Wog, Wog, Wog, Wog
Gs^Vh, Gs^Vh, Gs^Vh, Gg, Gg, Gg, Gg, Gg, Gs^Vh, Gg, Rr, Rr, Gg, Gg, Hh, Hh, Mm, Mm, Mm, Mm, Mm, Mm, Mm, Mm, Mm, Mm, Wwt, Mm, Mm, Mm, Mm, Mm, Hh, Hh, Rr, Rr, Ds, Ds, Wog, Wog, Wog, Wo, Wo, Wog, Wog, Wog, Wog, Wog, Wog, Wog, Wog, Wog, Wog, Wog, Wog, Wog, Wog, Wog, Wog, Wog, Wog, Wog
Rr, Gs^Vh, Rr, Gg, Rr, Gg, Gg, Gs^Vh, Rr, Rr, Gg, Gg, Gg, Gg, Mm, Mm, Mm, Mm, Mm, Mm, Mm, Mm, Mm, Mm, Mm, Wwt, Mm, Mm, Mm, Mm, Mm, Hh, Gg, Gs^Vh, Rr, Ds, Wog, Wog, Wog, Wog, Wog, Wog, Wog, Wog, Wog, Wog, Wog, Wog, Wog, Wog, Wog, Wog, Wog, Wog, Wog, Wog, Wog, Wog, Wog, Wog, Wog, Wog
Gg, Rr, Gg, Rr, Gg, Rr, Rr, Rr, Rr, Rr, Gg, Gg, Ch, Ch, Mm, Mm, Mm, Mm, Hh^Vhh, Mm, Hh, Mm, Mm, Mm, Wwt, Wwt, Mm, Mm, Mm, Mm, Mm, Hh, Rr, Rr, Rr, Wog, Wog, Wog, Wog, Wog, Wog, Wog, Wog, Wog, Wog, Wog, Wog, Wog, Wog, Wog, Wog, Wog, Wog, Wog, Wog, Wog, Wog, Wog, Wog, Wog, Wog, Wog
Gg, Gg^Gvs, Gg^Gvs, Gg^Gvs, Gg^Gvs, Gg^Gvs, Gg^Gvs, Gg^Eff, Gg^Eff, Rr, Rr, Gg, Ch, 1 Kh, Ch, Mm, Hh^Vhh, Hh^Vhh, Rr, Hh^Vhh, Rr, Hh, Mm, Wwt, Hh, Hh, Hh, Mm, Mm, Mm, Rr, Rr, Hh^Vhh, Gg, Rr, Wog, Wog, Wog, Wog, Wog, Wog, Wog, Wog, Wog, Wog, Wog, Wog, Wog, Wog, Wog, Wog, Wog, Wog, Wog, Wog, Wog, Wog, Wog, Wog, Wog, Wog, Wog
Ds, Gg^Gvs, Ds, Gg^Gvs, Gg^Gvs, Gg^Gvs, Gg^Gvs, Gg^Gvs, Gg^Gvs, Gg^Eff, Gg, Rr, Rr, Ch, Gs^Vh, Gs^Vh, Rr, Rr, Rr, Rr, Gs^Vh, Rr, Wwt^Bsb\, Wwt, Hh, Hh, Mm, Mm, Rr, Rr, Mm, Mm, Mm, Hh, Rr, Wog, Wog, Wog, Wog, Wog, Wog, Wog, Wog, Wog, Wog, Wog, Wog, Wog, Wog, Wog, Wog, Wog, Wog, Wog, Wog, Wog, Wog, Wog, Wog, Wog, Wog, Wog
Wog, Ds, Wog, Ds, Ds, Gg^Gvs, Gg^Gvs, Gg^Gvs, Gg^Gvs, Gg^Gvs, Ds, Gg, Gg, Rr, Rr, Rr, Gs^Vh, Gs^Vh, Rr^Vhc, Gs^Vh, Wwt, Wwt, Hh, Rr, Rr, Rr, Rr, Rr, Hh, Mm, Mm, Ms, Mm, Hh, Rr, Wog, Wog, Wog, Wog, Wog, Wog, Wog, Wog, Wog, Wog, Wog, Wog, Wog, Wog, Wog, Wog, Wog, Wog, Wog, Wog, Wog, Wog, Wog, Wog, Wog, Wog, Wog
Wog, Wog, Wog, Wog, Wog, Ds, Ds, Ds, Ds, Ds, Wog, Ds, Gg, Gg, Rr, Rr, Gs^Vh, Gg^Ve, Gs^Vh, Gs^Vh, Wwt, Gg, Gg, Rr, Hh, Hh, Hh, Hh, Hh, Hh, Mm, Ms, Mm, Hh, Rr, Ds, Ds, Wog, Wog, Wog, Wog, Wog, Wog, Wog, Wog, Wog, Wog, Wog, Wog, Wog, Wog, Wog, Wog, Wog, Wog, Wog, Wog, Wog, Wog, Wog, Wog, Wog
Wog, Wog, Wog, Wog, Wog, Wog, Wog, Wog, Wog, Wog, Wog, Ds, Gg, Gg, Rr, Rr, Gs^Vh, Gs^Vh, Wwt, Wwt, Gg, Gg, Gg, Rr, Hh, Ur, Ur, Ur, Hh, Hh, Mm, Ms, Mm, Hh, Hh, Rr, Rr, Ds, Wog, Wog, Wog, Wog, Wog, Wog, Wog, Wog, Wog, Wog, Wog, Wog, Wog, Wog, Wog, Wog, Wog, Wog, Wog, Wog, Wog, Wog, Wog, Wog
Wog, Wog, Wog, Wog, Wog, Wog, Wog, Wog, Wog, Wog, Ds, Ds, Gg, Gg, Gg, Rr, Wwt, Wwt, Wwt, Gg, Wwt, Gg, Gg, Rr, Hh, Ur, Hh, Hh, Hh, Hh^Vhh, Mm, Ms, Ms, Mm, Mm, Hh, Hh, Rr, Rr, Wog, Wwt, Wwt, Wwt, Wwt, Wwt, Wwt, Wwt, Wog, Wwt, Wog, Wog, Wog, Wog, Wog, Wog, Wog, Wog, Wog, Wog, Wog, Wog, Wog
Wog, Wog, Wog, Wog, Wog, Wog, Wog, Wog, Wog, Wog, Wwt, Gg, Wwt, Gg, Wwt, Wwt^Bsb|, Wwt, Wwt, Gg, Wwt, Gg, Wwt, Wwt, Wwt^Bsb|, Wwt, Hh, Wwt, Hh, Hh, Hh, Mm, Ms, Ms, Mm, Mm, Hh, Hh, Hh, Hh, Rr, Wwt, Wwt, Wwt, Wwt, Wwt, Wwt, Wwt, Wwt, Wwt, Wwt, Wog, Wog, Wog, Wog, Wog, Wog, Wog, Wog, Wog, Wog, Wog, Wog
Wog, Wog, Wog, Wog, Wog, Wog, Wog, Wog, Wog, Wog, Ds, Wwt, Gg, Wwt, Gg, Wwt^Bsb|, Rr, Rr, Rr, Gg, Gg, Gg, Hh, Hh, Hh, Wwt, Wwt, Wwt, Wwt, Wwt, Wwt, Mm, Mm, Ms, Mm, Mm, Mm, Hh, Hh, Rr, Rr, Wwt, Wwt, Wwt, Wwt, Wwt, Wwt, Wwt, Wwt, Wwt, Wwt, Wog, Wog, Wog, Wog, Wog, Wog, Wog, Wog, Wog, Wog, Wog
Wog, Wog, Wog, Wog, Wog, Wog, Wog, Wog, Wog, Wog, Ds, Gg, Hh, Gg, Gg^Wm, Rr, Gg^Gvs, Gg^Eff, Gg^Eff, Rr, Rr, Gg, Hh, Hh, Hh, Hh, Hh, Hh, Mm, Mm, Mm, Wwt, Mm, Ms, Ms, Mm, Mm, Mm, Hh, Hh, Rr^Eff, Ds^Eff, Wwt, Wwt, Wwt, Wwt, Wwt, Wwt, Wwt, Wwt, Wwt, Wwt, Wwt, Wog, Wog, Wog, Wog, Wog, Wog, Wog, Wog, Wog
Wog, Wog, Wog, Wog, Wog, Wog, Wog, Wog, Wog, Wog, Ds, Gg, Hh, Hh, Gg^Gvs, Gg^Gvs, Gg^Gvs, Gg^Gvs, Gg^Gvs, Gg^Eff, Gg^Eff, Rr, Hh, Hh, Hh, Hh^Vhh, Hh, Hh, Mm, Mm, Mm^Eff, Mm, Mm, Ms, Mm, Mm, Hh^Eff, Hh, Hh^Eff, Gg^Eff, Rr, Ds, Wwt, Wwt, Wwt, Wwt, Wwt, Wwt, Wwt, Wwt, Wwt, Wwt, Wwt, Wog, Wog, Wog, Wog, Wog, Wog, Wog, Wog, Wog
Wog, Wog, Wog, Wog, Wog, Wog, Wog, Wog, Wog, Wog, Ds, Gg, Gg, Gg, Ds, Gg^Gvs, Gg^Gvs, Gg^Gvs, Gg^Gvs, Gg^Gvs, Gg^Gvs, Rr, Rr, Hh, Hh, Hh, Mm, Mm, Mm^Eff, Mm^Eff, Mm, Mm^Eff, Ms, Ms, Mm^Eff, Mm, Hh, Hh^Eff, Hh, Gg, Rr, Ds, Ds, Wwt, Wwt, Wwt, Wwt, Wwt, Wwt, Ch, Wwt, Wwt, Wwt, Wwt, Wog, Wog, Wog, Wog, Wog, Wog, Wog, Wog
Wog, Wog, Wog, Wog, Wog, Wog, Wog, Wog, Wog, Wog, Ds, Gg, Ds, Ds, Wog, Ds, Ds, Ds, Ds, Gg^Gvs, Ds, Rr, Rr, Mm, Mm, Mm, Mm^Eff, Mm^Eff, Mm, Mm, Mm, Mm, Mm, Mv, Ms, Mm^Eff, Mm, Mm, Mm, Hh, Hh^Vhh, Rr, Ds, Wwt, Wwt, Wwt, Wwt, Wwt, Ch, Ch, Ch, Wwt, Wwt, Wwt, Wwt, Wog, Wog, Wog, Wog, Wog, Wog, Wog
Wog, Wog, Wog, Wog, Wog, Wog, Wog, Wog, Wog, Wog, Ds, Ds, Wog, Wog, Wog, Wog, Wog, Wog, Wog, Ds, Wog, Ds, Ds, Rr, Rr^Eff, Mm^Eff, Rr^Vhc, Mm, Mm, Mm, Mm, Mm, Mm, Mm, Mm, Mm, Wwt, Mm, Mm, Hh, Hh^Vhh, Rr, Rr, Wwf, Wwf, Wwt, Wwt, Wwt, Ch, Rr^Vhc, Ch, Wwt, Wwt, Wwt, Wwt, Wog, Wog, Wog, Wog, Wog, Wog, Wog
Wog, Wog, Wog, Wog, Wog, Wog, Wog, Wog, Wog, Wog, Wog, Wog, Wog, Wog, Wog, Wog, Wog, Wog, Wog, Wog, Wog, Wog, Wog, Ds^Eff, Wwt, Rr^Vhc, Rr^Vhc, Xos, Rr^Vhc, Mm, Hh, Hh, Hh, Mm, Mm, Mm, Wwt, Mm, Mm, Mm, Hh, Rr^Vhc, Rr, Wwf, Wwf, Wwf, Wwf, Ch, Rr^Vhc, Rr^Vhc, Rr^Vhc, Ch, Wwt, Wwt, Wwt, Wog, Wog, Wog, Wog, Wog, Wog, Wog
Wog, Wog, Wog, Wog, Wog, Wog, Wog, Wog, Wog, Wog, Wog, Wog, Wog, Wog, Wog, Wog, Wog, Wog, Wog, Wog, Wog, Wog, Wog, Wwt, Ds, Wwt^Bsb|, Wwt, Wwt, Wwt^Bsb|, Xos, Rr^Vhc, Hh, Hh, Mm, Wwt, Wwt, Hh, Mm, Ms, Mm, Hh, Rr^Vhc, Rr, Wwf, Wwf, Wwf, Ch, Ch, Rr^Vhc, Rr^Vhc, Rr^Vhc, Ch, Ch, Wwt, Wwt, Wog, Wog, Wog, Wog, Wog, Wog, Wog
Wog, Wog, Wog, Wog, Wog, Wog, Wog, Wog, Wog, Wog, Wog, Wog, Wog, Wog, Wog, Wog, Wog, Wog, Wog, Wog, Wog, Wog, Wog, Wog, Ds, Rr^Vhc, Rr^Vhc, Wwt, Rr^Vhc, Wwt^Bsb/, Wwt^Bsb|, Wwt, Wwt, Wwt, Wwt, Hh, Mm, Mm, Ms, Mm, Hh, Gg, Rr, Wwf, Wwf, Wwf, Ch, Rr^Vhc, Rr^Vhc, Rr^Vhc, Rr^Vhc, Rr^Vhc, Ch, Wwt, Wwt, Wog, Wog, Wog, Wog, Wog, Wog, Wog
Wog, Wog, Wog, Wog, Wog, Wog, Wog, Wog, Wog, Wog, Wog, Wog, Wog, Wog, Wog, Wog, Wog, Wog, Wog, Wog, Wog, Wog, Wog, Wog^Bw\, Xos, Rr^Vhc, Rr^Vhc, Xos, Rr^Vhc, Hh, Gs, Gg, Hh, Wwt, Wwt, Wwt, Mm, Mm, Ms, Mm, Hh, Gg, Rr, Wwf, Wwf, Ch, Rr^Vhc, Rr^Vhc, Rr^Vhc, Rr^Vhc, Rr^Vhc, Rr^Vhc, Rr^Vhc, Ch, Wwt, Wog, Wog, Wog, Wog, Wog, Wog, Wog
Wog, Wog, Wog, Wog, Wog, Wog, Wog, Wog, Wog, Wog, Wog, Wog, Wog, Wog, Wog, Wog, Wog, Wog, Wog, Wog, Ds, Wog, Ds, Ds, Gg, Rr^Vhc, Rr^Vhc, Rr^Vhc, Hh, Gs, Gs^Dr, Hh, Hh, Hh, Wwt, Mm, Mm, Mm, Ms, Mm, Hh, Hh, Rr, Wwf, Wwf, Ch, Ch, Rr^Vhc, Ch, 5 Kh, Ch, Rr^Vhc, Ch, Ch, Wog, Wog, Wog, Wog, Wog, Wog, Wog, Wog
Wog, Wog, Wog, Wog, Wog, Wog, Wog, Wog, Wog, Wog, Wog, Wog, Wog, Wog, Wog, Wog, Wog, Wog, Ds, Ds, Gg^Gvs, Ds, Gg^Wm, Gg, Gg, Rrc, Gg, Hh, Hh, Gs, Gs, Hh, Hh, Hh, Hh, Wwt, Mm, Mm, Mm, Ms, Mm, Hh, Rr, Wwt, Wwt, Wwt, Wwt, Ch, Ch, Ch, Ch, Ch, Wwt, Wwt, Wog, Wog, Wog, Wog, Wog, Wog, Wog, Wog
Wog, Wog, Wog, Wog, Wog, Wog, Wog, Wog, Wog, Wog, Wog, Wog, Wog, Wog, Wog, Wog, Ds, Ds, Gg^Gvs, Gg^Gvs, Gg^Gvs, Gg^Gvs, Hh, Hh, Hh, Rrc, Gg, Hh, Hh, Hh, Hh, Gs, Hh, Mm, Hh, Wwt, Wwt, Mm, Mm, Ms, Mm, Mm, Gg, Rr, Wwt, Wwt, Wwt, Wwt, Wwt, Ch, Wwt, Wwt, Wwt, Wwt, Wog, Wog, Wog, Wog, Wog, Wog, Wog, Wog
Wog, Wog, Wog, Wog, Wog, Wog, Wog, Wog, Wog, Wog, Wog, Wog, Wog, Wog, Wog, Wog, Wog, Ds, Ds, Gg^Gvs, Gg^Gvs, Gg^Gvs, Hh, Hh, Gg, Rr^Vhc, Rr^Vhc, Gg, Gg, Gg, Gs, Hh, Hh, Mm, Mm, Mm, Wwt, Mm, Mm, Ms, Mm, Mm, Hh, Rr, Wwt, Wwt, Wwt, Wwt, Wwt, Wwt, Wwt, Wwt, Wog, Wog, Wog, Wog, Wog, Wog, Wog, Wog, Wog, Wog
Wog, Wog, Wog, Wog, Wog, Wog, Wog, Wog, Wog, Wog, Wog, Wog, Wog, Wog, Wog, Wog, Wog, Wog, Wog, Ds, Ds, Gg^Gvs, Gg, Gg, Gg, Rr^Vhc, Rr^Vhc, Rrc, Rrc, Gg, Rrc, Gg, Hh, Hh^Vhh, Hh, Hh, Wwt, Mm, Mm, Ms, Ms, Mm, Hh, Rr, Rr, Wwt, Wwt, Wwt, Wwt, Wwt, Wwt, Wwt, Wog, Wog, Wog, Wog, Wog, Wog, Wog, Wog, Wog, Wog
Wog, Wog, Wog, Wog, Wog, Wog, Wog, Wog, Wog, Wog, Wog, Wog, Wog, Wog, Wog, Wog, Wog, Wog, Wog, Wog, Wog, Ds, Gg, Gg, Gg, Rrc, Gg, Gg, Gg, Rrc, Rrc, Rrc, Rrc, Hh, Hh, Hh, Mm, Mm, Mm, Mm, Mm, Mm, Mm, Gg, Rr, Wwt, Wwt, Wwt, Wwt, Wwt, Wog, Wog, Wog, Wog, Wog, Wog, Wog, Wog, Wog, Wog, Wog, Wog
Wog, Wog, Wog, Wog, Wog, Wog, Wog, Wog, Wog, Wog, Wog, Wog, Wog, Wog, Wog, Wog, Wog, Wog, Wog, Wog, Wog, Ds, Ch, Ch, Ch, Rrc, Gg, Gg, Wwt, Gg, Wwt, Rrc, Rrc, Hh, Hh, Mm, Mm, Mm, Mm, Mm, Mm, Mm, Mm, Hh, Rr, Wwt, Wog, Wog, Wog, Wog, Wog, Wog, Wog, Wog, Wog, Wog, Wog, Wog, Wog, Wog, Wog, Wog
Wog, Wog, Wog, Wog, Wog, Wog, Wog, Wog, Wog, Wog, Wog, Wog, Wog, Wog, Wog, Wog, Wog, Wog, Wog, Wog, Wog, Ds, Ch, 2 Kh, Ch, Rrc, Wwt, Wwt, Gg^Gvs, Wwt, Wwt, Wwt, Wwt, Rrc, Rrc, Hh^Vhh, Mm, Mm, Mm, Mm, Wwt, Mm, Mm, Hh, Rr, Wog, Wog, Wog, Wog, Wog, Wog, Wog, Wog, Wog, Wog, Wog, Wog, Wog, Wog, Wog, Wog, Wog
Wog, Wog, Wog, Wog, Wog, Wog, Wog, Wog, Wog, Wog, Wog, Wog, Wog, Wog, Wog, Wog, Wog, Wog, Wog, Wog, Wog, Ds, Ds, Ch, Wwt, Wwt^Bsb|, Gg^Gvs, Gg^Gvs, Hh, Hh, Wwt, Hh, Hh, Wwt, Wwt^Bsb|, Mm, Mm, Mm, Wwt, Wwt, Mm, Mm, Hh, Hh, Rr, Wog, Wog, Wog, Wog, Wog, Wog, Wog, Wog, Wog, Wog, Wog, Wog, Wog, Wog, Wog, Wog, Wog
Wog, Wog, Wog, Wog, Wog, Wog, Wog, Wog, Wog, Wog, Wog, Wog, Wog, Wog, Wog, Wog, Wog, Wog, Wog, Wog, Wog, Wog, Wwt, Gg, Wwt, Rrc, Gg^Gvs, Hh, Hh, Wwt, Mm, Mm, Mm, Hh, Rrc, Hh, Hh, Wwt, Wwt, Mm, Mm, Mm, Hh, Hh, Rr, Wog, Wog, Wog, Wog, Wog, Wog, Wog, Wog, Wog, Wog, Wog, Wog, Wog, Wog, Wog, Wog, Wog
Wog, Wog, Wog, Wog, Wog, Wog, Wog, Wog, Wog, Wog, Wog, Wog, Wog, Wog, Wog, Wog, Wog, Wog, Wog, Wog, Wog, Wog, Ds, Wwt, Gg, Rrc, Gg^Gvs, Hh, Hh, Wwt, Wwt, Mm, Mm, Mm, Mm, Rrc, Wwt^Bsb\, Wwt, Mm, Mm, Mm, Mm, Hh, Rr, Ds, Wog, Wog, Wog, Wog, Wog, Wog, Wog, Wog, Wog, Wog, Wog, Wog, Wog, Wog, Wog, Wog, Wog
Wog, Wog, Wog, Wog, Wog, Wog, Wog, Wog, Wog, Wog, Wog, Wog, Wog, Wog, Wog, Wog, Wog, Wog, Wog, Wog, Wog, Wog, Ds, Gg, Gg, Rrc, Gg^Gvs, Hh, Hh, Mm, Mm, Mm, Mm, Mm, Mm, Mm, Wwt, Rrc, Rrc, Rrc, Rrc, Mm, Rr^Vhc, Rr, Wog, Wog, Wog, Wog, Wog, Wog, Wog, Wog, Wog, Wog, Wog, Wog, Wog, Wog, Wog, Wog, Wog, Wog
Wog, Wog, Wog, Wog, Wog, Wog, Wog, Wog, Wog, Wog, Wog, Wog, Wog, Wog, Wog, Wog, Wog, Wog, Wog, Wog, Ds, Ds, Rrc, Rrc, Rrc, Rrc, Gg^Gvs, Hh, Hh, Mm, Mm, Mm, Mm, Mm, Mm, Wwt, Wwt, Hh, Mm, Mm, Mm, Rrc, Rrc, Rr, Wog, Wog, Wog, Wog, Wog, Wog, Wog, Wog, Wog, Wog, Wog, Wog, Wog, Wog, Wog, Wog, Wog, Wog
Wog, Wog, Wog, Wog, Wog, Wog, Wog, Wog, Wog, Wog, Wog, Wog, Wog, Wog, Wog, Wog, Wog, Wog, Ds, Ds, Rrc, Rrc, Gg, Gg, Wwt, Wwt^Bsb|, Wwt, Wwt, Wwt, Wwt, Mm, Mm, Mm, Mm, Mm, Wwt, Wwt, Hh, Mm, Mm, Rr^Vhc, Rr^Vhc, Rrc, Ds, Wog, Wog, Wog, Wog, Wog, Wog, Wog, Wog, Wog, Wog, Wog, Wog, Wog, Wog, Wog, Wog, Wog, Wog
Wog, Wog, Wog, Wog, Wog, Wog, Wog, Wog, Wog, Wog, Wog, Wog, Wog, Wog, Wog, Wog, Wog, Wog, Ds, Gg, Rrc, Gg, Wwt, Wwt, Rr^Vhc, Rrc, Rrc, Hh, Mm, Hh, Hh, Wwt, Wwt, Mm, Hh, Wwt, Hh, Mm, Mm, Mm, Rr^Vhc, Rrc, Ds, Wog, Wog, Wog, Wog, Wog, Wog, Wog, Wog, Wog, Wog, Wog, Wog, Wog, Wog, Wog, Wog, Wog, Wog, Wog
Wog, Wog, Wog, Wog, Wog, Wog, Wog, Wog, Wog, Wog, Wog, Wog, Wog, Wog, Wog, Wog, Wog, Wog^Bw\, Rr^Vhc, Rrc, Gg, Gg, Wwt, Rr^Vhc, Rr^Vhc, Rr^Vhc, Rrc, Hh, Hh, Hh, Hh, Hh, Gg^Gvs, Wwt, Wwt, Wwt, Hh, Mm, Mm, Mm, Hh, Rrc, Wog, Wog, Wog, Wog, Wog, Wog, Wog, Wog, Wog, Wog, Wog, Wog, Wog, Wog, Wog, Wog, Wog, Wog, Wog, Wog
Wog, Wog, Wog, Wog, Wog, Wog, Wog, Wog, Wog, Wog, Wog, Wog, Wog, Wog, Wog, Wog, Wog^Bw\, Wog, Rr^Vhc, Rr^Vhc, Gg, Wwt, Wwt, Gg, Rr^Vhc, Rr^Vhc, Rrc, Gg^Gvs, Gg^Gvs, Hh, Gg^Gvs, Hh, Gg^Gvs, Gg^Gvs, Gg^Gvs, Hh, Gg^Gvs, Hh, Hh, Hh, Rrc, Rrc, Wog, Wog, Wog, Wog, Wog, Wog, Wog, Wog, Wog, Wog, Wog, Wog, Wog, Wog, Wog, Wog, Wog, Wog, Wog, Wog
Wog, Wog, Wog, Wog, Wog, Wog, Wog, Wog, Wog, Wog, Wog, Wog, Wog, Wog, Wog, Wog, Wog, Rr^Vhc, Rr^Vhc, Rr^Vhc, Wwt, Wwt, Mm, Mm, Mm, Gg, Gg, Rrc, Rrc, Rrc, Rrc, Rrc, Rrc, Rrc, Rrc, Rrc, Rrc, Rrc, Rrc, Rrc, Wog, Wog, Wog, Wog, Wog, Wog, Wog, Wog, Wog, Wog, Wog, Wog, Wog, Wog, Wog, Wog, Wog, Wog, Wog, Wog, Wog, Wog
Wog, Wog, Wog, Wog, Wog, Wog, Wog, Wog, Wog, Wog, Wog, Wog, Wog, Wog, Wog, Wog, Wog, Ds, Wwt, Wwt, Gg, Gg, Mm, Mm, Mm, Gg, Gg, Gg, Ds, Gg, Gg, Gg, Gg, Gg, Wog, Gg, Wog, Wog^Bsb\, Wog^Bsb\, Wog, Wog, Wog, Wog, Wog, Wog, Wog, Wog, Wog, Wog, Wog, Wog, Wog, Wog, Wog, Wog, Wog, Wog, Wog, Wog, Wog, Wog, Wog
Wog, Wog, Wog, Wog, Wog, Wog, Wog, Wog, Wog, Wog, Wog, Wog, Wog, Wog, Wog, Wog, Wog, Wwt, Ds, Ds, Ds, Ds, Ds, Mm, Ds, Ds, Ds, Ds, Wog, Ds, Wog, Wog, Wog, Wog, Wog, Wog, Wog, Wog, Wog, Wog^Bsb\, Wog^Bsb\, Wog, Wog, Wog, Wog, Wog, Wog, Wog, Wog, Wog, Wog, Wog, Wog, Wog, Wog, Wog, Wog, Wog, Wog, Wog, Wog, Wog
Wog, Wog, Wog, Wog, Wog, Wog, Wog, Wog, Wog, Wog, Wog, Wog, Wog, Wog, Wog, Wog, Wog, Wog, Wog, Ds, Ds, Ds, Wog, Ds, Wog, Wog, Wog, Wog, Wog, Wog, Wog, Wog, Wog, Wog, Wog, Wog, Wog, Wog, Wog, Wog, Rr^Vhc, Rr^Vhc, Rr^Vhc, Wog, Wog, Wog, Wog, Wog, Wog, Wog, Wog, Wog, Wog, Wog, Wog, Wog, Wog, Wog, Wog, Wog, Wog, Wog
Wog, Wog, Wog, Wog, Wog, Wog, Wog, Wog, Wog, Wog, Wog, Wog, Wog, Wog, Wog, Wog, Wog, Wog, Wog, Ds, Wog^Bsb|, Wog, Wog, Wog, Wog, Wog, Wog, Wog, Wog, Wog, Wog, Wog, Wog, Wog, Wog, Wog, Wog, Wog, Wog, Wog, Ch, Ch, Ch, Rr^Vhc, Wog, Wog, Wog, Wog, Wog, Wog, Wog, Wog, Wog, Wog, Wog, Wog, Wog, Wog, Wog, Wog, Wog, Wog
Wog, Wog, Wog, Wog, Wog, Wog, Wog, Wog, Wog, Wog, Wog, Wog, Wog, Wog, Wog, Wog, Wo, Wog, Wog, Wog, Wog^Bsb|, Wog, Wog, Wog, Wog, Wog, Wog, Wog, Wog, Wog, Wog, Wog, Wog, Wog, Wog, Wog, Wog, Wog, Wog, Wog, Ch, 3 Kh, Ch, Rr^Vhc, Wog, Wog, Wog, Wog, Wog, Wog, Wog, Wog, Wog, Wog, Wog, Wog, Wog, Wog, Wog, Wog, Wog, Wog
Wog, Wog, Wog, Wog, Wog, Wog, Wog, Wog, Wog, Wog, Wog, Wog, Wog, Wog, Wo, Wo, Wo, Wo, Wo, Wo, Gg, Wog, Gg, Wog, Gg, Wog, Wog, Wog, Wog, Wog, Wog, Wog, Wog, Wog, Wog, Wog, Wog, Wog, Wog, Wog, Ds, Ch, Ds, Wog, Wog, Wog, Wog, Wog, Wog, Wog, Wog, Wog, Wog, Wog, Wog, Wog, Wog, Wog, Wog, Wog, Wog, Wog
Wog, Wog, Wog, Wog, Wog, Wog, Wog, Wog, Wog, Wog, Wog, Wog, Wog, Wo, Wo, Wo, Gg, Gg, Hh, Gg, Ms, Gg, Mm, Hh, Hh, Gg, Gg, Wog, Wog, Wog, Wog, Wog, Wog, Wog, Wog, Wog, Wog, Wog, Wog, Ds, Gg, Rr^Vhc, Ds, Wog, Wog, Wog, Wog, Wog, Wog, Wog, Wog, Wog, Wog, Wog, Wog, Wog, Wog, Wog, Wog, Wog, Wog, Wog
Wog, Wog, Wog, Wog, Wog, Wog, Wog, Wog, Wog, Wog, Wog, Wog, Wog, Wog, Hh, Gg, Mm, Mm, Ms, Ms, Ms^Xm, Ms, Ms, Mm, Mm, Hh, Wog, Gg, Wog, Wog, Wog, Wog, Wog, Wog, Wog, Wog, Wog, Wog, Wog, Ds, Ds, Ds, Wog, Wog, Wog, Wog, Wog, Wog, Wog, Wog, Wog, Wog, Wog, Wog, Wog, Wog, Wog, Wog, Wog, Wog, Wog, Wog
Wog, Wog, Wog, Wog, Wog, Wog, Wog, Wog, Wog, Wog, Wog, Wog, Wog, Hh, Hh, Mm, Mm, Ms, Gg, Ms^Xm, Ms^Xm, Ms^Xm, Gg, Ms, Mm, Hh, Wog, Wog, Wog, Wog, Wog, Wog, Wog, Wog, Wog, Wog, Wog, Wog, Wog, Wog, Wog, Wog, Wog, Wog, Wog, Wog, Wog, Wog, Wog, Wog, Wog, Wog, Wog, Wog, Wog, Wog, Wog, Wog, Wog, Wog, Wog, Wog
